genome	contig	EVE	EVE_start	EVE_end	context	contig_size	eve_size
Chordaria-linearis	C-linearis_contig13	C-linearis_EVE13-1	2214000	2562000	HVH	3542593	348000
Chordaria-linearis	C-linearis_contig14	C-linearis_EVE14-1	1169800	1345000	HVH	3470907	175200
Chordaria-linearis	C-linearis_contig41	C-linearis_EVE41-1	1091000	1132000	HVH	1992753	41000
Chordaria-linearis	C-linearis_contig85	C-linearis_EVE85-1	1	66000	HV	830466	65999
Chordaria-linearis	C-linearis_contig85	C-linearis_EVE85-2	688000	703000	HVH	830466	15000
Chrysoparadoxa-australica	C-australica_Contig_204	C-australica_EVE204-1	36000	39000	HVH	50444	3000
Chrysoparadoxa-australica	C-australica_Contig_903	C-australica_EVE903-1	1	19339	V	19339	19338
Chrysoparadoxa-australica	C-australica_Contig_1388	C-australica_EVE1388-1	1	10250	V	10250	10249
Chrysoparadoxa-australica	C-australica_Contig_1723	C-australica_EVE1723-1	1	6287	V	6287	6286
Chrysoparadoxa-australica	C-australica_Contig_5885	C-australica_EVE5885-1	1	1218	V	1218	1217
Desmarestia-dudresnayi	D-dudresnayi_contig2	D-dudresnayi_EVE2-1	1	140947	V	140947	140946
Desmarestia-dudresnayi	D-dudresnayi_contig18	D-dudresnayi_EVE18-1	15000	47000	HVH	86714	32000
Desmarestia-dudresnayi	D-dudresnayi_contig55	D-dudresnayi_EVE55-1	1	64687	V	64687	64686
Desmarestia-dudresnayi	D-dudresnayi_contig115	D-dudresnayi_EVE115-1	14000	25000	HVH	56582	11000
Desmarestia-dudresnayi	D-dudresnayi_contig1189	D-dudresnayi_EVE1189-1	1	29586	V	29586	29585
Desmarestia-dudresnayi	D-dudresnayi_contig1682	D-dudresnayi_EVE1682-1	2000	8000	HVH	26303	6000
Desmarestia-dudresnayi	D-dudresnayi_contig1813	D-dudresnayi_EVE1813-1	1000	5000	HVH	25607	4000
Desmarestia-dudresnayi	D-dudresnayi_contig1895	D-dudresnayi_EVE1895-1	6500	20000	HVH	25169	13500
Desmarestia-dudresnayi	D-dudresnayi_contig4073	D-dudresnayi_EVE4073-1	1	18378	V	18378	18377
Desmarestia-dudresnayi	D-dudresnayi_contig5251	D-dudresnayi_EVE5251-1	2500	11500	HVH	16305	9000
Desmarestia-dudresnayi	D-dudresnayi_contig5740	D-dudresnayi_EVE5740-1	9000	15000	HVH	15547	6000
Desmarestia-dudresnayi	D-dudresnayi_contig9947	D-dudresnayi_EVE9947-1	3000	11327	HV	11327	8327
Desmarestia-dudresnayi	D-dudresnayi_contig17601	D-dudresnayi_EVE17601-1	3500	7380	HV	7380	3880
Desmarestia-dudresnayi	D-dudresnayi_contig18709	D-dudresnayi_EVE18709-1	1	6996	V	6996	6995
Desmarestia-dudresnayi	D-dudresnayi_contig21823	D-dudresnayi_EVE21823-1	1	6034	V	6034	6033
Desmarestia-dudresnayi	D-dudresnayi_contig52435	D-dudresnayi_EVE52435-1	1	1866	V	1866	1865
Desmarestia-dudresnayi	D-dudresnayi_contig70877	D-dudresnayi_EVE70877-1	1	956	V	956	955
Desmarestia-herbacea_FEMALE	D-herbacea_F_contig11	D-herbacea_F_EVE11-1	797000	850000	HVH	1792951	53000
Desmarestia-herbacea_FEMALE	D-herbacea_F_contig86	D-herbacea_F_EVE86-1	927000	936000	HVH	1018879	9000
Desmarestia-herbacea_FEMALE	D-herbacea_F_contig284	D-herbacea_F_EVE284-1	1	25000	HV	509019	24999
Desmarestia-herbacea_FEMALE	D-herbacea_F_contig321	D-herbacea_F_EVE321-1	212000	256000	HVH	468051	44000
Desmarestia-herbacea_FEMALE	D-herbacea_F_contig417	D-herbacea_F_EVE417-1	1	70000	HV	349712	69999
Desmarestia-herbacea_FEMALE	D-herbacea_F_contig498	D-herbacea_F_EVE498-1	30000	70000	HVH	282492	40000
Desmarestia-herbacea_FEMALE	D-herbacea_F_contig604	D-herbacea_F_EVE604-1	134000	214687	HV	214687	80687
Desmarestia-herbacea_FEMALE	D-herbacea_F_contig669	D-herbacea_F_EVE669-1	160000	179741	HV	179741	19741
Desmarestia-herbacea_FEMALE	D-herbacea_F_contig713	D-herbacea_F_EVE713-1	31000	92000	HVH	160458	61000
Desmarestia-herbacea_FEMALE	D-herbacea_F_contig908	D-herbacea_F_EVE908-1	1	107239	V	107239	107238
Desmarestia-herbacea_FEMALE	D-herbacea_F_contig999	D-herbacea_F_EVE999-1	60000	91335	HV	91335	31335
Desmarestia-herbacea_MALE	D-herbacea_M_contig35	D-herbacea_M_EVE35-1	1332000	1354000	HVH	1752906	22000
Desmarestia-herbacea_MALE	D-herbacea_M_contig42	D-herbacea_M_EVE42-1	1	20000	HV	1622680	19999
Desmarestia-herbacea_MALE	D-herbacea_M_contig102	D-herbacea_M_EVE102-1	1	90000	HV	1130702	89999
Desmarestia-herbacea_MALE	D-herbacea_M_contig113	D-herbacea_M_EVE113-1	750000	765000	HVH	1053943	15000
Desmarestia-herbacea_MALE	D-herbacea_M_contig186	D-herbacea_M_EVE186-1	160000	176000	HVH	726705	16000
Desmarestia-herbacea_MALE	D-herbacea_M_contig237	D-herbacea_M_EVE237-1	1	30000	HV	568285	29999
Desmarestia-herbacea_MALE	D-herbacea_M_contig253	D-herbacea_M_EVE253-1	487000	539670	HV	539670	52670
Desmarestia-herbacea_MALE	D-herbacea_M_contig259	D-herbacea_M_EVE259-1	185000	217000	HVH	530455	32000
Desmarestia-herbacea_MALE	D-herbacea_M_contig301	D-herbacea_M_EVE301-1	1	20000	HV	456410	19999
Desmarestia-herbacea_MALE	D-herbacea_M_contig305	D-herbacea_M_EVE305-1	407000	453771	HV	453771	46771
Desmarestia-herbacea_MALE	D-herbacea_M_contig503	D-herbacea_M_EVE503-1	1	208199	V	208199	208198
Desmarestia-herbacea_MALE	D-herbacea_M_contig835	D-herbacea_M_EVE835-1	1	53189	V	53189	53188
Desmarestia-herbacea_MALE	D-herbacea_M_contig865	D-herbacea_M_EVE865-1	1	48160	V	48160	48159
Ectocarpus-crouaniorum-2c_FEMALE	E-crouaniorum-2c_F_contig10	E-crouaniorum-2c_F_EVE10-1	25773	108748	HV	108748	82975
Ectocarpus-crouaniorum-2c_FEMALE	E-crouaniorum-2c_F_contig17	E-crouaniorum-2c_F_EVE17-1	1000	3000	HVH	91253	2000
Ectocarpus-crouaniorum-2c_FEMALE	E-crouaniorum-2c_F_contig392	E-crouaniorum-2c_F_EVE392-1	1	24000	HV	45092	23999
Ectocarpus-crouaniorum-2c_FEMALE	E-crouaniorum-2c_F_contig428	E-crouaniorum-2c_F_EVE428-1	30000	40000	HVH	43674	10000
Ectocarpus-crouaniorum-2c_FEMALE	E-crouaniorum-2c_F_contig1157	E-crouaniorum-2c_F_EVE1157-1	1	29893	V	29893	29892
Ectocarpus-crouaniorum-2c_FEMALE	E-crouaniorum-2c_F_contig1278	E-crouaniorum-2c_F_EVE1278-1	1	28564	V	28564	28563
Ectocarpus-crouaniorum-2c_FEMALE	E-crouaniorum-2c_F_contig1361	E-crouaniorum-2c_F_EVE1361-1	1	27825	V	27825	27824
Ectocarpus-crouaniorum-2c_FEMALE	E-crouaniorum-2c_F_contig1507	E-crouaniorum-2c_F_EVE1507-1	1	26462	V	26462	26461
Ectocarpus-crouaniorum-2c_FEMALE	E-crouaniorum-2c_F_contig1518	E-crouaniorum-2c_F_EVE1518-1	1	11500	HV	26327	11499
Ectocarpus-crouaniorum-2c_FEMALE	E-crouaniorum-2c_F_contig1600	E-crouaniorum-2c_F_EVE1600-1	1	25667	V	25667	25666
Ectocarpus-crouaniorum-2c_FEMALE	E-crouaniorum-2c_F_contig1652	E-crouaniorum-2c_F_EVE1652-1	11000	15000	HVH	25236	4000
Ectocarpus-crouaniorum-2c_FEMALE	E-crouaniorum-2c_F_contig2094	E-crouaniorum-2c_F_EVE2094-1	1	22170	V	22170	22169
Ectocarpus-crouaniorum-2c_FEMALE	E-crouaniorum-2c_F_contig2207	E-crouaniorum-2c_F_EVE2207-1	1	21506	V	21506	21505
Ectocarpus-crouaniorum-2c_FEMALE	E-crouaniorum-2c_F_contig2273	E-crouaniorum-2c_F_EVE2273-1	1	21114	V	21114	21113
Ectocarpus-crouaniorum-2c_FEMALE	E-crouaniorum-2c_F_contig2292	E-crouaniorum-2c_F_EVE2292-1	1	15000	HV	21045	14999
Ectocarpus-crouaniorum-2c_FEMALE	E-crouaniorum-2c_F_contig2388	E-crouaniorum-2c_F_EVE2388-1	11000	20440	HV	20440	9440
Ectocarpus-crouaniorum-2c_FEMALE	E-crouaniorum-2c_F_contig2423	E-crouaniorum-2c_F_EVE2423-1	5000	16000	HVH	20261	11000
Ectocarpus-crouaniorum-2c_FEMALE	E-crouaniorum-2c_F_contig2425	E-crouaniorum-2c_F_EVE2425-1	1	20247	V	20247	20246
Ectocarpus-crouaniorum-2c_FEMALE	E-crouaniorum-2c_F_contig2651	E-crouaniorum-2c_F_EVE2651-1	14000	19085	HV	19085	5085
Ectocarpus-crouaniorum-2c_FEMALE	E-crouaniorum-2c_F_contig2687	E-crouaniorum-2c_F_EVE2687-1	1	18922	V	18922	18921
Ectocarpus-crouaniorum-2c_FEMALE	E-crouaniorum-2c_F_contig2713	E-crouaniorum-2c_F_EVE2713-1	14000	17000	HVH	18827	3000
Ectocarpus-crouaniorum-2c_FEMALE	E-crouaniorum-2c_F_contig2797	E-crouaniorum-2c_F_EVE2797-1	1000	4000	HVH	18302	3000
Ectocarpus-crouaniorum-2c_FEMALE	E-crouaniorum-2c_F_contig2831	E-crouaniorum-2c_F_EVE2831-1	9000	16000	HVH	18143	7000
Ectocarpus-crouaniorum-2c_FEMALE	E-crouaniorum-2c_F_contig2865	E-crouaniorum-2c_F_EVE2865-1	795	17997	HV	17997	17202
Ectocarpus-crouaniorum-2c_FEMALE	E-crouaniorum-2c_F_contig3150	E-crouaniorum-2c_F_EVE3150-1	1	16901	V	16901	16900
Ectocarpus-crouaniorum-2c_FEMALE	E-crouaniorum-2c_F_contig3277	E-crouaniorum-2c_F_EVE3277-1	5000	13000	HVH	16456	8000
Ectocarpus-crouaniorum-2c_FEMALE	E-crouaniorum-2c_F_contig3456	E-crouaniorum-2c_F_EVE3456-1	1	15869	V	15869	15868
Ectocarpus-crouaniorum-2c_FEMALE	E-crouaniorum-2c_F_contig3733	E-crouaniorum-2c_F_EVE3733-1	2500	4500	HVH	14971	2000
Ectocarpus-crouaniorum-2c_FEMALE	E-crouaniorum-2c_F_contig4000	E-crouaniorum-2c_F_EVE4000-1	1	14170	V	14170	14169
Ectocarpus-crouaniorum-2c_FEMALE	E-crouaniorum-2c_F_contig4234	E-crouaniorum-2c_F_EVE4234-1	11000	13000	HVH	13539	2000
Ectocarpus-crouaniorum-2c_FEMALE	E-crouaniorum-2c_F_contig4309	E-crouaniorum-2c_F_EVE4309-1	4000	6500	HVH	13354	2500
Ectocarpus-crouaniorum-2c_FEMALE	E-crouaniorum-2c_F_contig4419	E-crouaniorum-2c_F_EVE4419-1	7500	9500	HVH	13066	2000
Ectocarpus-crouaniorum-2c_FEMALE	E-crouaniorum-2c_F_contig4495	E-crouaniorum-2c_F_EVE4495-1	8000	9000	HVH	12909	1000
Ectocarpus-crouaniorum-2c_FEMALE	E-crouaniorum-2c_F_contig4521	E-crouaniorum-2c_F_EVE4521-1	3000	4500	HVH	12850	1500
Ectocarpus-crouaniorum-2c_FEMALE	E-crouaniorum-2c_F_contig4562	E-crouaniorum-2c_F_EVE4562-1	1	12749	V	12749	12748
Ectocarpus-crouaniorum-2c_FEMALE	E-crouaniorum-2c_F_contig4606	E-crouaniorum-2c_F_EVE4606-1	1	12632	V	12632	12631
Ectocarpus-crouaniorum-2c_FEMALE	E-crouaniorum-2c_F_contig5425	E-crouaniorum-2c_F_EVE5425-1	1	10933	V	10933	10932
Ectocarpus-crouaniorum-2c_FEMALE	E-crouaniorum-2c_F_contig5511	E-crouaniorum-2c_F_EVE5511-1	1	10798	V	10798	10797
Ectocarpus-crouaniorum-2c_FEMALE	E-crouaniorum-2c_F_contig5630	E-crouaniorum-2c_F_EVE5630-1	1	10559	V	10559	10558
Ectocarpus-crouaniorum-2c_FEMALE	E-crouaniorum-2c_F_contig6168	E-crouaniorum-2c_F_EVE6168-1	3000	6000	HVH	9598	3000
Ectocarpus-crouaniorum-2c_FEMALE	E-crouaniorum-2c_F_contig6349	E-crouaniorum-2c_F_EVE6349-1	3500	8500	HVH	9341	5000
Ectocarpus-crouaniorum-2c_FEMALE	E-crouaniorum-2c_F_contig6444	E-crouaniorum-2c_F_EVE6444-1	6000	7500	HVH	9187	1500
Ectocarpus-crouaniorum-2c_FEMALE	E-crouaniorum-2c_F_contig6543	E-crouaniorum-2c_F_EVE6543-1	5500	8000	HVH	9038	2500
Ectocarpus-crouaniorum-2c_FEMALE	E-crouaniorum-2c_F_contig6589	E-crouaniorum-2c_F_EVE6589-1	1	8971	V	8971	8970
Ectocarpus-crouaniorum-2c_FEMALE	E-crouaniorum-2c_F_contig6671	E-crouaniorum-2c_F_EVE6671-1	1000	3500	HVH	8844	2500
Ectocarpus-crouaniorum-2c_FEMALE	E-crouaniorum-2c_F_contig6821	E-crouaniorum-2c_F_EVE6821-1	1	8650	V	8650	8649
Ectocarpus-crouaniorum-2c_FEMALE	E-crouaniorum-2c_F_contig6963	E-crouaniorum-2c_F_EVE6963-1	1	8444	V	8444	8443
Ectocarpus-crouaniorum-2c_FEMALE	E-crouaniorum-2c_F_contig7270	E-crouaniorum-2c_F_EVE7270-1	1	8036	V	8036	8035
Ectocarpus-crouaniorum-2c_FEMALE	E-crouaniorum-2c_F_contig7300	E-crouaniorum-2c_F_EVE7300-1	1	7999	V	7999	7998
Ectocarpus-crouaniorum-2c_FEMALE	E-crouaniorum-2c_F_contig7336	E-crouaniorum-2c_F_EVE7336-1	1	7934	V	7934	7933
Ectocarpus-crouaniorum-2c_FEMALE	E-crouaniorum-2c_F_contig7610	E-crouaniorum-2c_F_EVE7610-1	1	7572	V	7572	7571
Ectocarpus-crouaniorum-2c_FEMALE	E-crouaniorum-2c_F_contig7745	E-crouaniorum-2c_F_EVE7745-1	1	7412	V	7412	7411
Ectocarpus-crouaniorum-2c_FEMALE	E-crouaniorum-2c_F_contig7789	E-crouaniorum-2c_F_EVE7789-1	1	7369	V	7369	7368
Ectocarpus-crouaniorum-2c_FEMALE	E-crouaniorum-2c_F_contig7961	E-crouaniorum-2c_F_EVE7961-1	2500	5000	HVH	7167	2500
Ectocarpus-crouaniorum-2c_FEMALE	E-crouaniorum-2c_F_contig8749	E-crouaniorum-2c_F_EVE8749-1	1	6293	V	6293	6292
Ectocarpus-crouaniorum-2c_FEMALE	E-crouaniorum-2c_F_contig8889	E-crouaniorum-2c_F_EVE8889-1	1	6147	V	6147	6146
Ectocarpus-crouaniorum-2c_FEMALE	E-crouaniorum-2c_F_contig9386	E-crouaniorum-2c_F_EVE9386-1	1	3000	HV	5698	2999
Ectocarpus-crouaniorum-2c_FEMALE	E-crouaniorum-2c_F_contig10016	E-crouaniorum-2c_F_EVE10016-1	1	5140	V	5140	5139
Ectocarpus-crouaniorum-2c_FEMALE	E-crouaniorum-2c_F_contig10139	E-crouaniorum-2c_F_EVE10139-1	1	5045	V	5045	5044
Ectocarpus-crouaniorum-2c_FEMALE	E-crouaniorum-2c_F_contig11374	E-crouaniorum-2c_F_EVE11374-1	500	1500	HVH	4137	1000
Ectocarpus-crouaniorum-2c_FEMALE	E-crouaniorum-2c_F_contig11780	E-crouaniorum-2c_F_EVE11780-1	1	3880	V	3880	3879
Ectocarpus-crouaniorum-2c_FEMALE	E-crouaniorum-2c_F_contig12089	E-crouaniorum-2c_F_EVE12089-1	1	3703	V	3703	3702
Ectocarpus-crouaniorum-2c_FEMALE	E-crouaniorum-2c_F_contig12348	E-crouaniorum-2c_F_EVE12348-1	1	1600	HV	3539	1599
Ectocarpus-crouaniorum-2c_FEMALE	E-crouaniorum-2c_F_contig12372	E-crouaniorum-2c_F_EVE12372-1	1	3526	V	3526	3525
Ectocarpus-crouaniorum-2c_FEMALE	E-crouaniorum-2c_F_contig14115	E-crouaniorum-2c_F_EVE14115-1	1000	2656	HV	2656	1656
Ectocarpus-crouaniorum-2c_FEMALE	E-crouaniorum-2c_F_contig15990	E-crouaniorum-2c_F_EVE15990-1	1	1915	V	1915	1914
Ectocarpus-crouaniorum-2c_MALE	E-crouaniorum-2c_M_contig8	E-crouaniorum-2c_M_EVE8-1	1	56000	HV	5129499	55999
Ectocarpus-crouaniorum-2c_MALE	E-crouaniorum-2c_M_contig10	E-crouaniorum-2c_M_EVE10-1	36337	85000	HVH	4781826	48663
Ectocarpus-crouaniorum-2c_MALE	E-crouaniorum-2c_M_contig18	E-crouaniorum-2c_M_EVE18-1	3895000	4093417	HV	4093417	198417
Ectocarpus-crouaniorum-2c_MALE	E-crouaniorum-2c_M_contig22	E-crouaniorum-2c_M_EVE22-1	442000	489210	HVH	3883774	47210
Ectocarpus-crouaniorum-2c_MALE	E-crouaniorum-2c_M_contig28	E-crouaniorum-2c_M_EVE28-1	2363500	2375500	HVH	3147699	12000
Ectocarpus-crouaniorum-2c_MALE	E-crouaniorum-2c_M_contig29	E-crouaniorum-2c_M_EVE29-1	1181200	1188800	HVH	3136686	7600
Ectocarpus-crouaniorum-2c_MALE	E-crouaniorum-2c_M_contig40	E-crouaniorum-2c_M_EVE40-1	2157000	2212220	HV	2212220	55220
Ectocarpus-crouaniorum-2c_MALE	E-crouaniorum-2c_M_contig58	E-crouaniorum-2c_M_EVE58-1	268800	305900	HVH	1000573	37100
Ectocarpus-crouaniorum-2c_MALE	E-crouaniorum-2c_M_contig60	E-crouaniorum-2c_M_EVE60-1	1	175000	HV	984712	174999
Ectocarpus-crouaniorum-2c_MALE	E-crouaniorum-2c_M_contig81	E-crouaniorum-2c_M_EVE81-1	8000	19000	HVH	327586	11000
Ectocarpus-crouaniorum-2c_MALE	E-crouaniorum-2c_M_contig90	E-crouaniorum-2c_M_EVE90-1	106500	133000	HVH	144222	26500
Ectocarpus-fasciculatus_FEMALE	E-fasciculatus_F_contig440	E-fasciculatus_F_EVE440-1	1	27958	V	27958	27957
Ectocarpus-fasciculatus_FEMALE	E-fasciculatus_F_contig711	E-fasciculatus_F_EVE711-1	1	23841	V	23841	23840
Ectocarpus-fasciculatus_FEMALE	E-fasciculatus_F_contig3131	E-fasciculatus_F_EVE3131-1	1	12194	V	12194	12193
Ectocarpus-fasciculatus_FEMALE	E-fasciculatus_F_contig3915	E-fasciculatus_F_EVE3915-1	1900	9500	HVH	10674	7600
Ectocarpus-fasciculatus_MALE	E-fasciculatus_M_contig12	E-fasciculatus_M_EVE12-1	1027800	1035500	HVH	2015735	7700
Ectocarpus-fasciculatus_MALE	E-fasciculatus_M_contig15	E-fasciculatus_M_EVE15-1	1719000	1724700	HVH	1779014	5700
Ectocarpus-fasciculatus_MALE	E-fasciculatus_M_contig22	E-fasciculatus_M_EVE22-1	1129700	1135100	HVH	1436258	5400
Ectocarpus-fasciculatus_MALE	E-fasciculatus_M_contig35	E-fasciculatus_M_EVE35-1	443500	446500	HVH	1191558	3000
Ectocarpus-fasciculatus_MALE	E-fasciculatus_M_contig382	E-fasciculatus_M_EVE382-1	1	128280	V	128280	128279
Ectocarpus-fasciculatus_MALE	E-fasciculatus_M_contig464	E-fasciculatus_M_EVE464-1	25600	34800	HVH	89882	9200
Ectocarpus-fasciculatus_MALE	E-fasciculatus_M_contig474	E-fasciculatus_M_EVE474-1	45500	51800	HVH	87771	6300
Ectocarpus-siliculosus-1a_FEMALE	E-siliculosus-1a_F_contig300	E-siliculosus-1a_F_EVE300-1	51000	55000	HVH	63931	4000
Ectocarpus-siliculosus-1a_FEMALE	E-siliculosus-1a_F_contig1646	E-siliculosus-1a_F_EVE1646-1	1	29773	V	29773	29772
Ectocarpus-siliculosus-1a_FEMALE	E-siliculosus-1a_F_contig1890	E-siliculosus-1a_F_EVE1890-1	1	16000	HV	27305	15999
Ectocarpus-siliculosus-1a_FEMALE	E-siliculosus-1a_F_contig2143	E-siliculosus-1a_F_EVE2143-1	1	24931	V	24931	24930
Ectocarpus-siliculosus-1a_FEMALE	E-siliculosus-1a_F_contig2820	E-siliculosus-1a_F_EVE2820-1	8000	14000	HVH	20065	6000
Ectocarpus-siliculosus-1a_FEMALE	E-siliculosus-1a_F_contig2838	E-siliculosus-1a_F_EVE2838-1	1	19919	V	19919	19918
Ectocarpus-siliculosus-1a_FEMALE	E-siliculosus-1a_F_contig2939	E-siliculosus-1a_F_EVE2939-1	1	19260	V	19260	19259
Ectocarpus-siliculosus-1a_FEMALE	E-siliculosus-1a_F_contig3040	E-siliculosus-1a_F_EVE3040-1	1	3000	HV	18725	2999
Ectocarpus-siliculosus-1a_FEMALE	E-siliculosus-1a_F_contig3262	E-siliculosus-1a_F_EVE3262-1	1	17416	V	17416	17415
Ectocarpus-siliculosus-1a_FEMALE	E-siliculosus-1a_F_contig4872	E-siliculosus-1a_F_EVE4872-1	1	11039	V	11039	11038
Ectocarpus-siliculosus-1a_FEMALE	E-siliculosus-1a_F_contig5860	E-siliculosus-1a_F_EVE5860-1	2000	6000	HVH	8425	4000
Ectocarpus-siliculosus-1a_FEMALE	E-siliculosus-1a_F_contig5948	E-siliculosus-1a_F_EVE5948-1	1	8198	V	8198	8197
Ectocarpus-siliculosus-1a_FEMALE	E-siliculosus-1a_F_contig6339	E-siliculosus-1a_F_EVE6339-1	1	7336	V	7336	7335
Ectocarpus-siliculosus-1a_FEMALE	E-siliculosus-1a_F_contig7397	E-siliculosus-1a_F_EVE7397-1	1	5467	V	5467	5466
Ectocarpus-siliculosus-1a_MALE	E-siliculosus-1a_M_contig17	E-siliculosus-1a_M_EVE17-1	1	70000	HV	1704711	69999
Ectocarpus-siliculosus-1a_MALE	E-siliculosus-1a_M_contig41	E-siliculosus-1a_M_EVE41-1	235700	238900	HVH	1142087	3200
Ectocarpus-siliculosus-1a_MALE	E-siliculosus-1a_M_contig64	E-siliculosus-1a_M_EVE64-1	1000	30000	HVH	927213	29000
Ectocarpus-siliculosus-1a_MALE	E-siliculosus-1a_M_contig68	E-siliculosus-1a_M_EVE68-1	832000	880261	HV	880261	48261
Ectocarpus-siliculosus-1a_MALE	E-siliculosus-1a_M_contig78	E-siliculosus-1a_M_EVE78-1	751000	765500	HVH	790541	14500
Ectocarpus-siliculosus-1a_MALE	E-siliculosus-1a_M_contig96	E-siliculosus-1a_M_EVE96-1	555000	596000	HVH	658879	41000
Ectocarpus-siliculosus-1a_MALE	E-siliculosus-1a_M_contig99	E-siliculosus-1a_M_EVE99-1	6000	16000	HVH	641832	10000
Ectocarpus-siliculosus-1a_MALE	E-siliculosus-1a_M_contig134	E-siliculosus-1a_M_EVE134-1	1	82000	HV	438372	81999
Ectocarpus-siliculosus-1a_MALE	E-siliculosus-1a_M_contig167	E-siliculosus-1a_M_EVE167-1	12000	22000	HVH	341229	10000
Ectocarpus-siliculosus-1a_MALE	E-siliculosus-1a_M_contig287	E-siliculosus-1a_M_EVE287-1	1	35000	HV	124411	34999
Ectocarpus-siliculosus-1a_MALE	E-siliculosus-1a_M_contig289	E-siliculosus-1a_M_EVE289-1	1	121611	V	121611	121610
Ectocarpus-siliculosus-1a_MALE	E-siliculosus-1a_M_contig347	E-siliculosus-1a_M_EVE347-1	1	16000	HV	80694	15999
Ectocarpus-siliculosus-1a_MALE	E-siliculosus-1a_M_contig447	E-siliculosus-1a_M_EVE447-1	1	45823	V	45823	45822
Ectocarpus-siliculosus-1a_MALE	E-siliculosus-1a_M_contig454	E-siliculosus-1a_M_EVE454-1	1	36000	HV	43428	35999
Ectocarpus-siliculosus-1a_MALE	E-siliculosus-1a_M_contig483	E-siliculosus-1a_M_EVE483-1	1	16000	HV	37534	15999
Ectocarpus-siliculosus-1a_MALE	E-siliculosus-1a_M_contig487	E-siliculosus-1a_M_EVE487-1	5000	10000	HVH	36610	5000
Ectocarpus-siliculosus-1a_MALE	E-siliculosus-1a_M_contig501	E-siliculosus-1a_M_EVE501-1	1	34569	V	34569	34568
Ectocarpus-siliculosus-1a_MALE	E-siliculosus-1a_M_contig519	E-siliculosus-1a_M_EVE519-1	1	8727	HV	32307	8726
Ectocarpus-siliculosus-1a_MALE	E-siliculosus-1a_M_contig595	E-siliculosus-1a_M_EVE595-1	1	23212	V	23212	23211
Ectocarpus-siliculosus-1a_MALE	E-siliculosus-1a_M_contig685	E-siliculosus-1a_M_EVE685-1	7000	14454	HV	14454	7454
Ectocarpus-siliculosus-1a_MALE	E-siliculosus-1a_M_contig1031	E-siliculosus-1a_M_EVE1031-1	1	2821	V	2821	2820
Ectocarpus-sp1_FEMALE	Ecto-sp1_F_contig117	Ecto-sp1_F_EVE117-1	26600	29000	HVH	79913	2400
Ectocarpus-sp1_FEMALE	Ecto-sp1_F_contig251	Ecto-sp1_F_EVE251-1	1	64539	V	64539	64538
Ectocarpus-sp1_FEMALE	Ecto-sp1_F_contig699	Ecto-sp1_F_EVE699-1	1	44800	HV	46442	44799
Ectocarpus-sp1_FEMALE	Ecto-sp1_F_contig1037	Ecto-sp1_F_EVE1037-1	1	38412	V	38412	38411
Ectocarpus-sp1_FEMALE	Ecto-sp1_F_contig1076	Ecto-sp1_F_EVE1076-1	20500	32300	HVH	37707	11800
Ectocarpus-sp1_FEMALE	Ecto-sp1_F_contig1126	Ecto-sp1_F_EVE1126-1	19600	34700	HVH	36909	15100
Ectocarpus-sp1_FEMALE	Ecto-sp1_F_contig1456	Ecto-sp1_F_EVE1456-1	15000	25400	HVH	31972	10400
Ectocarpus-sp1_FEMALE	Ecto-sp1_F_contig1652	Ecto-sp1_F_EVE1652-1	20000	24000	HVH	29694	4000
Ectocarpus-sp1_FEMALE	Ecto-sp1_F_contig1653	Ecto-sp1_F_EVE1653-1	1	25000	HV	29673	24999
Ectocarpus-sp1_FEMALE	Ecto-sp1_F_contig1858	Ecto-sp1_F_EVE1858-1	1	27319	V	27319	27318
Ectocarpus-sp1_FEMALE	Ecto-sp1_F_contig2331	Ecto-sp1_F_EVE2331-1	5500	14500	HVH	23466	9000
Ectocarpus-sp1_FEMALE	Ecto-sp1_F_contig2465	Ecto-sp1_F_EVE2465-1	1	12000	HV	22457	11999
Ectocarpus-sp1_FEMALE	Ecto-sp1_F_contig2547	Ecto-sp1_F_EVE2547-1	1	21858	V	21858	21857
Ectocarpus-sp1_FEMALE	Ecto-sp1_F_contig2548	Ecto-sp1_F_EVE2548-1	1	10000	HV	21857	9999
Ectocarpus-sp1_FEMALE	Ecto-sp1_F_contig2603	Ecto-sp1_F_EVE2603-1	1	17500	HV	21510	17499
Ectocarpus-sp1_FEMALE	Ecto-sp1_F_contig3015	Ecto-sp1_F_EVE3015-1	1	10000	HV	19213	9999
Ectocarpus-sp1_FEMALE	Ecto-sp1_F_contig3213	Ecto-sp1_F_EVE3213-1	1	6000	HV	18200	5999
Ectocarpus-sp1_FEMALE	Ecto-sp1_F_contig3341	Ecto-sp1_F_EVE3341-1	1	6500	HV	17535	6499
Ectocarpus-sp1_FEMALE	Ecto-sp1_F_contig3417	Ecto-sp1_F_EVE3417-1	1	3600	HV	17138	3599
Ectocarpus-sp1_FEMALE	Ecto-sp1_F_contig3538	Ecto-sp1_F_EVE3538-1	6000	12000	HVH	16599	6000
Ectocarpus-sp1_FEMALE	Ecto-sp1_F_contig5442	Ecto-sp1_F_EVE5442-1	1	10264	V	10264	10263
Ectocarpus-sp1_FEMALE	Ecto-sp1_F_contig5772	Ecto-sp1_F_EVE5772-1	1	9446	V	9446	9445
Ectocarpus-sp1_FEMALE	Ecto-sp1_F_contig6046	Ecto-sp1_F_EVE6046-1	1	8847	V	8847	8846
Ectocarpus-sp1_FEMALE	Ecto-sp1_F_contig6284	Ecto-sp1_F_EVE6284-1	1	5000	HV	8290	4999
Ectocarpus-sp1_MALE	Ecto-sp1_M_contig139	Ecto-sp1_M_EVE139-1	1	32000	HV	77682	31999
Ectocarpus-sp1_MALE	Ecto-sp1_M_contig265	Ecto-sp1_M_EVE265-1	4500	10000	HVH	64107	5500
Ectocarpus-sp1_MALE	Ecto-sp1_M_contig496	Ecto-sp1_M_EVE496-1	46000	49000	HVH	52315	3000
Ectocarpus-sp1_MALE	Ecto-sp1_M_contig1194	Ecto-sp1_M_EVE1194-1	1	35429	V	35429	35428
Ectocarpus-sp1_MALE	Ecto-sp1_M_contig1321	Ecto-sp1_M_EVE1321-1	14500	25000	HVH	33624	10500
Ectocarpus-sp1_MALE	Ecto-sp1_M_contig1335	Ecto-sp1_M_EVE1335-1	15000	24500	HVH	33420	9500
Ectocarpus-sp1_MALE	Ecto-sp1_M_contig1767	Ecto-sp1_M_EVE1767-1	20000	26000	HVH	28533	6000
Ectocarpus-sp1_MALE	Ecto-sp1_M_contig1831	Ecto-sp1_M_EVE1831-1	10000	16000	HVH	27900	6000
Ectocarpus-sp1_MALE	Ecto-sp1_M_contig2104	Ecto-sp1_M_EVE2104-1	1	25172	V	25172	25171
Ectocarpus-sp1_MALE	Ecto-sp1_M_contig2200	Ecto-sp1_M_EVE2200-1	1	24351	V	24351	24350
Ectocarpus-sp1_MALE	Ecto-sp1_M_contig2355	Ecto-sp1_M_EVE2355-1	1	15000	HV	23227	14999
Ectocarpus-sp1_MALE	Ecto-sp1_M_contig2498	Ecto-sp1_M_EVE2498-1	1	22235	V	22235	22234
Ectocarpus-sp1_MALE	Ecto-sp1_M_contig2598	Ecto-sp1_M_EVE2598-1	5000	16900	HVH	21622	11900
Ectocarpus-sp1_MALE	Ecto-sp1_M_contig2699	Ecto-sp1_M_EVE2699-1	14000	21020	HV	21020	7020
Ectocarpus-sp1_MALE	Ecto-sp1_M_contig3117	Ecto-sp1_M_EVE3117-1	1	9900	HV	18710	9899
Ectocarpus-sp1_MALE	Ecto-sp1_M_contig3947	Ecto-sp1_M_EVE3947-1	1	14915	V	14915	14914
Ectocarpus-sp1_MALE	Ecto-sp1_M_contig4479	Ecto-sp1_M_EVE4479-1	1	13022	V	13022	13021
Ectocarpus-sp1_MALE	Ecto-sp1_M_contig5138	Ecto-sp1_M_EVE5138-1	1	11006	V	11006	11005
Ectocarpus-sp1_MALE	Ecto-sp1_M_contig5959	Ecto-sp1_M_EVE5959-1	1	8860	V	8860	8859
Ectocarpus-sp1_MALE	Ecto-sp1_M_contig6445	Ecto-sp1_M_EVE6445-1	1	7723	V	7723	7722
Ectocarpus-sp2_FEMALE	Ecto-sp2_F_contig732	Ecto-sp2_F_EVE732-1	29000	34590	HV	34590	5590
Ectocarpus-sp2_FEMALE	Ecto-sp2_F_contig1666	Ecto-sp2_F_EVE1666-1	14000	20731	HVH	22643	6731
Ectocarpus-sp2_FEMALE	Ecto-sp2_F_contig1858	Ecto-sp2_F_EVE1858-1	1	21373	V	21373	21372
Ectocarpus-sp2_FEMALE	Ecto-sp2_F_contig2359	Ecto-sp2_F_EVE2359-1	5500	18643	HV	18643	13143
Ectocarpus-sp2_FEMALE	Ecto-sp2_F_contig2779	Ecto-sp2_F_EVE2779-1	10000	16200	HVH	16943	6200
Ectocarpus-sp2_FEMALE	Ecto-sp2_F_contig3316	Ecto-sp2_F_EVE3316-1	1	15242	V	15242	15241
Ectocarpus-sp2_FEMALE	Ecto-sp2_F_contig3488	Ecto-sp2_F_EVE3488-1	1	14694	V	14694	14693
Ectocarpus-sp2_FEMALE	Ecto-sp2_F_contig6976	Ecto-sp2_F_EVE6976-1	1	8614	V	8614	8613
Ectocarpus-sp2_FEMALE	Ecto-sp2_F_contig8032	Ecto-sp2_F_EVE8032-1	1	7633	V	7633	7632
Ectocarpus-sp2_FEMALE	Ecto-sp2_F_contig13569	Ecto-sp2_F_EVE13569-1	1	4364	V	4364	4363
Ectocarpus-sp2_FEMALE	Ecto-sp2_F_contig15373	Ecto-sp2_F_EVE15373-1	1	3693	V	3693	3692
Ectocarpus-sp2_FEMALE	Ecto-sp2_F_contig16602	Ecto-sp2_F_EVE16602-1	1	3318	V	3318	3317
Ectocarpus-sp2_MALE	Ecto-sp2_M_contig268	Ecto-sp2_M_EVE268-1	29000	38000	HVH	40890	9000
Ectocarpus-sp2_MALE	Ecto-sp2_M_contig545	Ecto-sp2_M_EVE545-1	18000	30100	HVH	32725	12100
Ectocarpus-sp2_MALE	Ecto-sp2_M_contig748	Ecto-sp2_M_EVE748-1	1	24000	HV	29208	23999
Ectocarpus-sp2_MALE	Ecto-sp2_M_contig1369	Ecto-sp2_M_EVE1369-1	1	22957	V	22957	22956
Ectocarpus-sp2_MALE	Ecto-sp2_M_contig2317	Ecto-sp2_M_EVE2317-1	8500	13000	HVH	17604	4500
Ectocarpus-sp2_MALE	Ecto-sp2_M_contig7216	Ecto-sp2_M_EVE7216-1	1	7888	V	7888	7887
Ectocarpus-sp3_FEMALE	Ecto-sp3_F_contig1	Ecto-sp3_F_EVE1-1	1	143893	V	143893	143892
Ectocarpus-sp3_FEMALE	Ecto-sp3_F_contig14	Ecto-sp3_F_EVE14-1	1	57559	V	57559	57558
Ectocarpus-sp3_FEMALE	Ecto-sp3_F_contig30	Ecto-sp3_F_EVE30-1	31000	50162	HV	50162	19162
Ectocarpus-sp3_FEMALE	Ecto-sp3_F_contig50	Ecto-sp3_F_EVE50-1	1	45612	V	45612	45611
Ectocarpus-sp3_FEMALE	Ecto-sp3_F_contig217	Ecto-sp3_F_EVE217-1	3000	31635	HV	31635	28635
Ectocarpus-sp3_FEMALE	Ecto-sp3_F_contig334	Ecto-sp3_F_EVE334-1	1	28225	V	28225	28224
Ectocarpus-sp3_FEMALE	Ecto-sp3_F_contig353	Ecto-sp3_F_EVE353-1	15500	27935	HV	27935	12435
Ectocarpus-sp3_FEMALE	Ecto-sp3_F_contig561	Ecto-sp3_F_EVE561-1	1	24258	V	24258	24257
Ectocarpus-sp3_FEMALE	Ecto-sp3_F_contig648	Ecto-sp3_F_EVE648-1	1	23129	V	23129	23128
Ectocarpus-sp3_FEMALE	Ecto-sp3_F_contig790	Ecto-sp3_F_EVE790-1	1	21462	V	21462	21461
Ectocarpus-sp3_FEMALE	Ecto-sp3_F_contig877	Ecto-sp3_F_EVE877-1	6000	11000	HVH	20572	5000
Ectocarpus-sp3_FEMALE	Ecto-sp3_F_contig884	Ecto-sp3_F_EVE884-1	1	20533	V	20533	20532
Ectocarpus-sp3_FEMALE	Ecto-sp3_F_contig1026	Ecto-sp3_F_EVE1026-1	10200	14700	HVH	19574	4500
Ectocarpus-sp3_FEMALE	Ecto-sp3_F_contig1124	Ecto-sp3_F_EVE1124-1	6550	15000	HVH	18892	8450
Ectocarpus-sp3_FEMALE	Ecto-sp3_F_contig1611	Ecto-sp3_F_EVE1611-1	1	16606	V	16606	16605
Ectocarpus-sp3_FEMALE	Ecto-sp3_F_contig2069	Ecto-sp3_F_EVE2069-1	1	15068	V	15068	15067
Ectocarpus-sp3_FEMALE	Ecto-sp3_F_contig2571	Ecto-sp3_F_EVE2571-1	1	13672	V	13672	13671
Ectocarpus-sp3_FEMALE	Ecto-sp3_F_contig2634	Ecto-sp3_F_EVE2634-1	3000	13529	HV	13529	10529
Ectocarpus-sp3_FEMALE	Ecto-sp3_F_contig2932	Ecto-sp3_F_EVE2932-1	2500	12874	HV	12874	10374
Ectocarpus-sp3_FEMALE	Ecto-sp3_F_contig5057	Ecto-sp3_F_EVE5057-1	1	9647	V	9647	9646
Ectocarpus-sp3_FEMALE	Ecto-sp3_F_contig5882	Ecto-sp3_F_EVE5882-1	1	8810	V	8810	8809
Ectocarpus-sp3_FEMALE	Ecto-sp3_F_contig6023	Ecto-sp3_F_EVE6023-1	1	8667	V	8667	8666
Ectocarpus-sp3_FEMALE	Ecto-sp3_F_contig6354	Ecto-sp3_F_EVE6354-1	1	8384	V	8384	8383
Ectocarpus-sp3_FEMALE	Ecto-sp3_F_contig7918	Ecto-sp3_F_EVE7918-1	1	7162	V	7162	7161
Ectocarpus-sp3_FEMALE	Ecto-sp3_F_contig12782	Ecto-sp3_F_EVE12782-1	1	4749	V	4749	4748
Ectocarpus-sp3_FEMALE	Ecto-sp3_F_contig13523	Ecto-sp3_F_EVE13523-1	1	4478	V	4478	4477
Ectocarpus-sp3_FEMALE	Ecto-sp3_F_contig15590	Ecto-sp3_F_EVE15590-1	1	3867	V	3867	3866
Ectocarpus-sp3_FEMALE	Ecto-sp3_F_contig19887	Ecto-sp3_F_EVE19887-1	1	2886	V	2886	2885
Ectocarpus-sp3_FEMALE	Ecto-sp3_F_contig24213	Ecto-sp3_F_EVE24213-1	1	2190	V	2190	2189
Ectocarpus-sp3_MALE	Ecto-sp3_M_contig1	Ecto-sp3_M_EVE1-1	1	500135	V	500135	500134
Ectocarpus-sp3_MALE	Ecto-sp3_M_contig5	Ecto-sp3_M_EVE5-1	1	82300	HV	90318	82299
Ectocarpus-sp3_MALE	Ecto-sp3_M_contig6	Ecto-sp3_M_EVE6-1	1	84633	V	84633	84632
Ectocarpus-sp3_MALE	Ecto-sp3_M_contig32	Ecto-sp3_M_EVE32-1	37400	50938	HV	50938	13538
Ectocarpus-sp3_MALE	Ecto-sp3_M_contig87	Ecto-sp3_M_EVE87-1	1	43153	V	43153	43152
Ectocarpus-sp3_MALE	Ecto-sp3_M_contig390	Ecto-sp3_M_EVE390-1	1	30045	V	30045	30044
Ectocarpus-sp3_MALE	Ecto-sp3_M_contig435	Ecto-sp3_M_EVE435-1	1	29067	V	29067	29066
Ectocarpus-sp3_MALE	Ecto-sp3_M_contig885	Ecto-sp3_M_EVE885-1	1	12000	HV	23088	11999
Ectocarpus-sp3_MALE	Ecto-sp3_M_contig1031	Ecto-sp3_M_EVE1031-1	1	21758	V	21758	21757
Ectocarpus-sp3_MALE	Ecto-sp3_M_contig1042	Ecto-sp3_M_EVE1042-1	1	21683	V	21683	21682
Ectocarpus-sp3_MALE	Ecto-sp3_M_contig1325	Ecto-sp3_M_EVE1325-1	1000	14000	HVH	19764	13000
Ectocarpus-sp3_MALE	Ecto-sp3_M_contig1384	Ecto-sp3_M_EVE1384-1	1	19339	V	19339	19338
Ectocarpus-sp3_MALE	Ecto-sp3_M_contig1744	Ecto-sp3_M_EVE1744-1	1	17765	V	17765	17764
Ectocarpus-sp3_MALE	Ecto-sp3_M_contig1766	Ecto-sp3_M_EVE1766-1	10000	16000	HVH	17643	6000
Ectocarpus-sp3_MALE	Ecto-sp3_M_contig2290	Ecto-sp3_M_EVE2290-1	1	15644	V	15644	15643
Ectocarpus-sp3_MALE	Ecto-sp3_M_contig2625	Ecto-sp3_M_EVE2625-1	4500	11000	HVH	14664	6500
Ectocarpus-sp3_MALE	Ecto-sp3_M_contig3789	Ecto-sp3_M_EVE3789-1	1	12178	V	12178	12177
Ectocarpus-sp3_MALE	Ecto-sp3_M_contig4188	Ecto-sp3_M_EVE4188-1	1	11524	V	11524	11523
Ectocarpus-sp3_MALE	Ecto-sp3_M_contig5228	Ecto-sp3_M_EVE5228-1	1	10130	V	10130	10129
Ectocarpus-sp3_MALE	Ecto-sp3_M_contig6524	Ecto-sp3_M_EVE6524-1	1	8754	V	8754	8753
Ectocarpus-sp3_MALE	Ecto-sp3_M_contig7348	Ecto-sp3_M_EVE7348-1	1	7977	V	7977	7976
Ectocarpus-sp3_MALE	Ecto-sp3_M_contig7651	Ecto-sp3_M_EVE7651-1	1	7735	V	7735	7734
Ectocarpus-sp3_MALE	Ecto-sp3_M_contig8612	Ecto-sp3_M_EVE8612-1	1	6963	V	6963	6962
Ectocarpus-sp3_MALE	Ecto-sp3_M_contig8635	Ecto-sp3_M_EVE8635-1	1	6949	V	6949	6948
Ectocarpus-sp3_MALE	Ecto-sp3_M_contig11797	Ecto-sp3_M_EVE11797-1	1	5178	V	5178	5177
Ectocarpus-sp3_MALE	Ecto-sp3_M_contig12973	Ecto-sp3_M_EVE12973-1	1	4664	V	4664	4663
Ectocarpus-sp3_MALE	Ecto-sp3_M_contig13092	Ecto-sp3_M_EVE13092-1	1	4616	V	4616	4615
Ectocarpus-sp3_MALE	Ecto-sp3_M_contig13923	Ecto-sp3_M_EVE13923-1	1	4298	V	4298	4297
Ectocarpus-sp3_MALE	Ecto-sp3_M_contig15077	Ecto-sp3_M_EVE15077-1	1	3912	V	3912	3911
Ectocarpus-sp3_MALE	Ecto-sp3_M_contig15630	Ecto-sp3_M_EVE15630-1	1	3739	V	3739	3738
Ectocarpus-sp4_FEMALE	Ecto-sp4_F_contig337	Ecto-sp4_F_EVE337-1	1	37205	V	37205	37204
Ectocarpus-sp4_FEMALE	Ecto-sp4_F_contig1088	Ecto-sp4_F_EVE1088-1	5280	11376	HVH	24328	6096
Ectocarpus-sp4_FEMALE	Ecto-sp4_F_contig1144	Ecto-sp4_F_EVE1144-1	1	23712	V	23712	23711
Ectocarpus-sp4_FEMALE	Ecto-sp4_F_contig3776	Ecto-sp4_F_EVE3776-1	1	12642	V	12642	12641
Ectocarpus-sp4_FEMALE	Ecto-sp4_F_contig4220	Ecto-sp4_F_EVE4220-1	1	11780	V	11780	11779
Ectocarpus-sp4_FEMALE	Ecto-sp4_F_contig6496	Ecto-sp4_F_EVE6496-1	1	8510	V	8510	8509
Ectocarpus-sp4_MALE	Ecto-sp4_M_contig11	Ecto-sp4_M_EVE11-1	1	131604	V	131604	131603
Ectocarpus-sp4_MALE	Ecto-sp4_M_contig187	Ecto-sp4_M_EVE187-1	15000	68103	HV	68103	53103
Ectocarpus-sp4_MALE	Ecto-sp4_M_contig329	Ecto-sp4_M_EVE329-1	24000	38000	HVH	57943	14000
Ectocarpus-sp4_MALE	Ecto-sp4_M_contig866	Ecto-sp4_M_EVE866-1	1	40169	V	40169	40168
Ectocarpus-sp4_MALE	Ecto-sp4_M_contig1599	Ecto-sp4_M_EVE1599-1	1	29669	V	29669	29668
Ectocarpus-sp4_MALE	Ecto-sp4_M_contig1899	Ecto-sp4_M_EVE1899-1	1	26767	V	26767	26766
Ectocarpus-sp4_MALE	Ecto-sp4_M_contig2232	Ecto-sp4_M_EVE2232-1	1	24322	V	24322	24321
Ectocarpus-sp4_MALE	Ecto-sp4_M_contig2503	Ecto-sp4_M_EVE2503-1	1	22347	V	22347	22346
Ectocarpus-sp4_MALE	Ecto-sp4_M_contig3201	Ecto-sp4_M_EVE3201-1	1	18532	V	18532	18531
Ectocarpus-sp4_MALE	Ecto-sp4_M_contig3740	Ecto-sp4_M_EVE3740-1	1	16138	V	16138	16137
Ectocarpus-sp4_MALE	Ecto-sp4_M_contig3744	Ecto-sp4_M_EVE3744-1	1	16125	V	16125	16124
Ectocarpus-sp4_MALE	Ecto-sp4_M_contig3880	Ecto-sp4_M_EVE3880-1	2700	6200	HVH	15577	3500
Ectocarpus-sp4_MALE	Ecto-sp4_M_contig3959	Ecto-sp4_M_EVE3959-1	1	15192	V	15192	15191
Ectocarpus-sp4_MALE	Ecto-sp4_M_contig4189	Ecto-sp4_M_EVE4189-1	1	14309	V	14309	14308
Ectocarpus-sp4_MALE	Ecto-sp4_M_contig4782	Ecto-sp4_M_EVE4782-1	1	9500	HV	12285	9499
Ectocarpus-sp4_MALE	Ecto-sp4_M_contig4801	Ecto-sp4_M_EVE4801-1	1	12235	V	12235	12234
Ectocarpus-sp4_MALE	Ecto-sp4_M_contig6834	Ecto-sp4_M_EVE6834-1	1	7520	V	7520	7519
Ectocarpus-sp4_MALE	Ecto-sp4_M_contig7428	Ecto-sp4_M_EVE7428-1	1	6524	V	6524	6523
Ectocarpus-sp4_MALE	Ecto-sp4_M_contig8014	Ecto-sp4_M_EVE8014-1	1	5630	V	5630	5629
Ectocarpus-sp5_FEMALE	Ecto-sp5_F_contig1354	Ecto-sp5_F_EVE1354-1	13100	25881	HV	25881	12781
Ectocarpus-sp5_FEMALE	Ecto-sp5_F_contig2531	Ecto-sp5_F_EVE2531-1	1	18252	V	18252	18251
Ectocarpus-sp5_FEMALE	Ecto-sp5_F_contig5321	Ecto-sp5_F_EVE5321-1	1	9983	V	9983	9982
Ectocarpus-sp5_FEMALE	Ecto-sp5_F_contig6912	Ecto-sp5_F_EVE6912-1	1	7355	V	7355	7354
Ectocarpus-sp5_MALE	Ecto-sp5_M_contig2283	Ecto-sp5_M_EVE2283-1	1	10608	V	10608	10607
Ectocarpus-sp6_FEMALE	Ecto-sp6_F_contig4	Ecto-sp6_F_EVE4-1	1015000	1066200	HVH	3693489	51200
Ectocarpus-sp6_FEMALE	Ecto-sp6_F_contig25	Ecto-sp6_F_EVE25-1	372900	434400	HVH	2007894	61500
Ectocarpus-sp6_FEMALE	Ecto-sp6_F_contig34	Ecto-sp6_F_EVE34-1	1492400	1751700	HVH	1815782	259300
Ectocarpus-sp6_FEMALE	Ecto-sp6_F_contig37	Ecto-sp6_F_EVE37-1	1	48000	HV	1682509	47999
Ectocarpus-sp6_FEMALE	Ecto-sp6_F_contig38	Ecto-sp6_F_EVE38-1	525000	530000	HVH	1666107	5000
Ectocarpus-sp6_FEMALE	Ecto-sp6_F_contig48	Ecto-sp6_F_EVE48-1	1289000	1300100	HVH	1319670	11100
Ectocarpus-sp6_FEMALE	Ecto-sp6_F_contig53	Ecto-sp6_F_EVE53-1	28500	39500	HVH	1277097	11000
Ectocarpus-sp6_FEMALE	Ecto-sp6_F_contig64	Ecto-sp6_F_EVE64-1	104000	117800	HVH	1052853	13800
Ectocarpus-sp6_FEMALE	Ecto-sp6_F_contig67	Ecto-sp6_F_EVE67-1	53900	136300	HVH	1016948	82400
Ectocarpus-sp6_FEMALE	Ecto-sp6_F_contig85	Ecto-sp6_F_EVE85-1	222300	225300	HVH	792967	3000
Ectocarpus-sp6_FEMALE	Ecto-sp6_F_contig96	Ecto-sp6_F_EVE96-1	75800	86500	HVH	686381	10700
Ectocarpus-sp6_FEMALE	Ecto-sp6_F_contig114	Ecto-sp6_F_EVE114-1	145500	165500	HVH	571759	20000
Ectocarpus-sp6_FEMALE	Ecto-sp6_F_contig133	Ecto-sp6_F_EVE133-1	1	446134	V	446134	446133
Ectocarpus-sp6_FEMALE	Ecto-sp6_F_contig138	Ecto-sp6_F_EVE138-1	371800	402400	HVH	423293	30600
Ectocarpus-sp6_FEMALE	Ecto-sp6_F_contig140	Ecto-sp6_F_EVE140-1	359900	409688	HV	409688	49788
Ectocarpus-sp6_FEMALE	Ecto-sp6_F_contig161	Ecto-sp6_F_EVE161-1	232800	279012	HV	279012	46212
Ectocarpus-sp6_FEMALE	Ecto-sp6_F_contig162	Ecto-sp6_F_EVE162-1	179600	276865	HV	276865	97265
Ectocarpus-sp6_FEMALE	Ecto-sp6_F_contig195	Ecto-sp6_F_EVE195-1	67900	76700	HVH	175435	8800
Ectocarpus-sp6_FEMALE	Ecto-sp6_F_contig345	Ecto-sp6_F_EVE345-1	36300	66968	HV	66968	30668
Ectocarpus-sp6_FEMALE	Ecto-sp6_F_contig399	Ecto-sp6_F_EVE399-1	1	45915	V	45915	45914
Ectocarpus-sp6_FEMALE	Ecto-sp6_F_contig422	Ecto-sp6_F_EVE422-1	1	35530	V	35530	35529
Ectocarpus-sp8_MALE	Ecto-sp8_M_contig2	Ecto-sp8_M_EVE2-1	1	69573	V	69573	69572
Ectocarpus-sp8_MALE	Ecto-sp8_M_contig25	Ecto-sp8_M_EVE25-1	19000	29000	HVH	36859	10000
Ectocarpus-sp8_MALE	Ecto-sp8_M_contig100	Ecto-sp8_M_EVE100-1	2400	16000	HVH	30676	13600
Ectocarpus-sp8_MALE	Ecto-sp8_M_contig119	Ecto-sp8_M_EVE119-1	1	29753	V	29753	29752
Ectocarpus-sp8_MALE	Ecto-sp8_M_contig121	Ecto-sp8_M_EVE121-1	1	29643	V	29643	29642
Ectocarpus-sp8_MALE	Ecto-sp8_M_contig194	Ecto-sp8_M_EVE194-1	1	26618	V	26618	26617
Ectocarpus-sp8_MALE	Ecto-sp8_M_contig196	Ecto-sp8_M_EVE196-1	1	26458	V	26458	26457
Ectocarpus-sp8_MALE	Ecto-sp8_M_contig423	Ecto-sp8_M_EVE423-1	1	22135	V	22135	22134
Ectocarpus-sp8_MALE	Ecto-sp8_M_contig517	Ecto-sp8_M_EVE517-1	1	21017	V	21017	21016
Ectocarpus-sp8_MALE	Ecto-sp8_M_contig689	Ecto-sp8_M_EVE689-1	1	19718	V	19718	19717
Ectocarpus-sp8_MALE	Ecto-sp8_M_contig1250	Ecto-sp8_M_EVE1250-1	1	16517	V	16517	16516
Ectocarpus-sp8_MALE	Ecto-sp8_M_contig1421	Ecto-sp8_M_EVE1421-1	1	15841	V	15841	15840
Ectocarpus-sp8_MALE	Ecto-sp8_M_contig3536	Ecto-sp8_M_EVE3536-1	1	11511	V	11511	11510
Ectocarpus-sp8_MALE	Ecto-sp8_M_contig6336	Ecto-sp8_M_EVE6336-1	1	8951	V	8951	8950
Ectocarpus-sp8_MALE	Ecto-sp8_M_contig6616	Ecto-sp8_M_EVE6616-1	1	8764	V	8764	8763
Ectocarpus-sp8_MALE	Ecto-sp8_M_contig6781	Ecto-sp8_M_EVE6781-1	1	8663	V	8663	8662
Ectocarpus-sp8_MALE	Ecto-sp8_M_contig7076	Ecto-sp8_M_EVE7076-1	1	8481	V	8481	8480
Ectocarpus-sp8_MALE	Ecto-sp8_M_contig10736	Ecto-sp8_M_EVE10736-1	1	6730	V	6730	6729
Ectocarpus-sp8_MALE	Ecto-sp8_M_contig11377	Ecto-sp8_M_EVE11377-1	1	6497	V	6497	6496
Ectocarpus-sp8_MALE	Ecto-sp8_M_contig24181	Ecto-sp8_M_EVE24181-1	1	3669	V	3669	3668
Ectocarpus-sp9_FEMALE	Ecto-sp9_F_contig108	Ecto-sp9_F_EVE108-1	1	57786	V	57786	57785
Ectocarpus-sp9_FEMALE	Ecto-sp9_F_contig1275	Ecto-sp9_F_EVE1275-1	1	13300	HV	25030	13299
Ectocarpus-sp9_FEMALE	Ecto-sp9_F_contig2059	Ecto-sp9_F_EVE2059-1	1	19407	V	19407	19406
Ectocarpus-sp9_FEMALE	Ecto-sp9_F_contig3059	Ecto-sp9_F_EVE3059-1	1	15401	V	15401	15400
Ectocarpus-sp9_FEMALE	Ecto-sp9_F_contig3076	Ecto-sp9_F_EVE3076-1	1	15355	V	15355	15354
Ectocarpus-sp9_FEMALE	Ecto-sp9_F_contig7385	Ecto-sp9_F_EVE7385-1	1	7247	V	7247	7246
Ectocarpus-sp9_FEMALE	Ecto-sp9_F_contig7985	Ecto-sp9_F_EVE7985-1	1	6611	V	6611	6610
Ectocarpus-sp9_FEMALE	Ecto-sp9_F_contig8683	Ecto-sp9_F_EVE8683-1	1	5914	V	5914	5913
Ectocarpus-sp9_FEMALE	Ecto-sp9_F_contig8752	Ecto-sp9_F_EVE8752-1	1	5868	V	5868	5867
Ectocarpus-sp9_FEMALE	Ecto-sp9_F_contig8973	Ecto-sp9_F_EVE8973-1	1	5679	V	5679	5678
Ectocarpus-sp9_FEMALE	Ecto-sp9_F_contig9816	Ecto-sp9_F_EVE9816-1	1	5009	V	5009	5008
Ectocarpus-sp9_FEMALE	Ecto-sp9_F_contig11141	Ecto-sp9_F_EVE11141-1	1	4144	V	4144	4143
Ectocarpus-sp9_FEMALE	Ecto-sp9_F_contig11507	Ecto-sp9_F_EVE11507-1	1	3935	V	3935	3934
Ectocarpus-sp12_FEMALE	Ecto-sp12_F_contig2	Ecto-sp12_F_EVE2-1	1	108083	V	108083	108082
Ectocarpus-sp12_FEMALE	Ecto-sp12_F_contig5	Ecto-sp12_F_EVE5-1	1	96541	V	96541	96540
Ectocarpus-sp12_FEMALE	Ecto-sp12_F_contig147	Ecto-sp12_F_EVE147-1	1	52265	V	52265	52264
Ectocarpus-sp12_FEMALE	Ecto-sp12_F_contig166	Ecto-sp12_F_EVE166-1	1	50661	V	50661	50660
Ectocarpus-sp12_FEMALE	Ecto-sp12_F_contig221	Ecto-sp12_F_EVE221-1	1	46836	V	46836	46835
Ectocarpus-sp12_FEMALE	Ecto-sp12_F_contig408	Ecto-sp12_F_EVE408-1	1	40203	V	40203	40202
Ectocarpus-sp12_FEMALE	Ecto-sp12_F_contig1132	Ecto-sp12_F_EVE1132-1	1	28917	V	28917	28916
Ectocarpus-sp12_FEMALE	Ecto-sp12_F_contig1954	Ecto-sp12_F_EVE1954-1	1	23606	V	23606	23605
Ectocarpus-sp12_FEMALE	Ecto-sp12_F_contig2082	Ecto-sp12_F_EVE2082-1	1	22973	V	22973	22972
Ectocarpus-sp12_FEMALE	Ecto-sp12_F_contig2146	Ecto-sp12_F_EVE2146-1	1	22726	V	22726	22725
Ectocarpus-sp12_FEMALE	Ecto-sp12_F_contig2861	Ecto-sp12_F_EVE2861-1	1	20104	V	20104	20103
Ectocarpus-sp12_FEMALE	Ecto-sp12_F_contig3160	Ecto-sp12_F_EVE3160-1	1	19210	V	19210	19209
Ectocarpus-sp12_FEMALE	Ecto-sp12_F_contig3662	Ecto-sp12_F_EVE3662-1	1	17966	V	17966	17965
Ectocarpus-sp12_FEMALE	Ecto-sp12_F_contig3847	Ecto-sp12_F_EVE3847-1	1	17547	V	17547	17546
Ectocarpus-sp12_FEMALE	Ecto-sp12_F_contig5173	Ecto-sp12_F_EVE5173-1	11500	15096	HV	15096	3596
Ectocarpus-sp12_FEMALE	Ecto-sp12_F_contig5221	Ecto-sp12_F_EVE5221-1	1	15020	V	15020	15019
Ectocarpus-sp12_FEMALE	Ecto-sp12_F_contig5460	Ecto-sp12_F_EVE5460-1	1	14660	V	14660	14659
Ectocarpus-sp12_FEMALE	Ecto-sp12_F_contig5577	Ecto-sp12_F_EVE5577-1	1	14510	V	14510	14509
Ectocarpus-sp12_FEMALE	Ecto-sp12_F_contig7048	Ecto-sp12_F_EVE7048-1	1	12704	V	12704	12703
Ectocarpus-sp12_FEMALE	Ecto-sp12_F_contig7298	Ecto-sp12_F_EVE7298-1	1	12456	V	12456	12455
Ectocarpus-sp12_FEMALE	Ecto-sp12_F_contig8114	Ecto-sp12_F_EVE8114-1	1	11663	V	11663	11662
Ectocarpus-sp12_FEMALE	Ecto-sp12_F_contig8967	Ecto-sp12_F_EVE8967-1	1	10894	V	10894	10893
Ectocarpus-sp12_FEMALE	Ecto-sp12_F_contig9986	Ecto-sp12_F_EVE9986-1	1	10105	V	10105	10104
Ectocarpus-sp12_FEMALE	Ecto-sp12_F_contig10253	Ecto-sp12_F_EVE10253-1	3500	9910	HV	9910	6410
Ectocarpus-sp12_FEMALE	Ecto-sp12_F_contig11480	Ecto-sp12_F_EVE11480-1	1	9127	V	9127	9126
Ectocarpus-sp12_FEMALE	Ecto-sp12_F_contig12822	Ecto-sp12_F_EVE12822-1	1	8373	V	8373	8372
Ectocarpus-sp12_FEMALE	Ecto-sp12_F_contig12880	Ecto-sp12_F_EVE12880-1	1	8338	V	8338	8337
Ectocarpus-sp12_FEMALE	Ecto-sp12_F_contig13333	Ecto-sp12_F_EVE13333-1	1	8110	V	8110	8109
Ectocarpus-sp12_FEMALE	Ecto-sp12_F_contig14788	Ecto-sp12_F_EVE14788-1	1	7402	V	7402	7401
Ectocarpus-sp12_FEMALE	Ecto-sp12_F_contig15399	Ecto-sp12_F_EVE15399-1	1	7151	V	7151	7150
Ectocarpus-sp12_FEMALE	Ecto-sp12_F_contig15611	Ecto-sp12_F_EVE15611-1	1	7053	V	7053	7052
Ectocarpus-sp12_FEMALE	Ecto-sp12_F_contig15857	Ecto-sp12_F_EVE15857-1	1	6953	V	6953	6952
Ectocarpus-sp12_FEMALE	Ecto-sp12_F_contig16037	Ecto-sp12_F_EVE16037-1	1	6879	V	6879	6878
Ectocarpus-sp12_FEMALE	Ecto-sp12_F_contig17929	Ecto-sp12_F_EVE17929-1	1	6176	V	6176	6175
Ectocarpus-sp12_FEMALE	Ecto-sp12_F_contig18111	Ecto-sp12_F_EVE18111-1	1	6107	V	6107	6106
Ectocarpus-sp12_FEMALE	Ecto-sp12_F_contig18171	Ecto-sp12_F_EVE18171-1	1	6084	V	6084	6083
Ectocarpus-sp12_FEMALE	Ecto-sp12_F_contig19894	Ecto-sp12_F_EVE19894-1	1	5535	V	5535	5534
Ectocarpus-sp12_FEMALE	Ecto-sp12_F_contig20236	Ecto-sp12_F_EVE20236-1	1	5432	V	5432	5431
Ectocarpus-sp12_FEMALE	Ecto-sp12_F_contig20856	Ecto-sp12_F_EVE20856-1	1	5259	V	5259	5258
Ectocarpus-sp12_FEMALE	Ecto-sp12_F_contig21576	Ecto-sp12_F_EVE21576-1	1	5066	V	5066	5065
Ectocarpus-sp12_FEMALE	Ecto-sp12_F_contig22600	Ecto-sp12_F_EVE22600-1	1	4808	V	4808	4807
Ectocarpus-sp12_FEMALE	Ecto-sp12_F_contig23059	Ecto-sp12_F_EVE23059-1	1	4701	V	4701	4700
Ectocarpus-sp12_FEMALE	Ecto-sp12_F_contig23582	Ecto-sp12_F_EVE23582-1	1	4572	V	4572	4571
Ectocarpus-sp12_FEMALE	Ecto-sp12_F_contig23874	Ecto-sp12_F_EVE23874-1	1	4507	V	4507	4506
Ectocarpus-sp12_FEMALE	Ecto-sp12_F_contig25495	Ecto-sp12_F_EVE25495-1	1	4167	V	4167	4166
Ectocarpus-sp12_FEMALE	Ecto-sp12_F_contig25848	Ecto-sp12_F_EVE25848-1	1	4091	V	4091	4090
Ectocarpus-sp12_FEMALE	Ecto-sp12_F_contig26308	Ecto-sp12_F_EVE26308-1	1	3994	V	3994	3993
Ectocarpus-sp12_FEMALE	Ecto-sp12_F_contig29685	Ecto-sp12_F_EVE29685-1	1	3374	V	3374	3373
Ectocarpus-sp12_MALE	Ecto-sp12_M_contig1	Ecto-sp12_M_EVE1-1	1	144395	V	144395	144394
Ectocarpus-sp12_MALE	Ecto-sp12_M_contig2	Ecto-sp12_M_EVE2-1	1	127968	V	127968	127967
Ectocarpus-sp12_MALE	Ecto-sp12_M_contig100	Ecto-sp12_M_EVE100-1	1	51777	V	51777	51776
Ectocarpus-sp12_MALE	Ecto-sp12_M_contig303	Ecto-sp12_M_EVE303-1	1	40181	V	40181	40180
Ectocarpus-sp12_MALE	Ecto-sp12_M_contig428	Ecto-sp12_M_EVE428-1	1	36705	V	36705	36704
Ectocarpus-sp12_MALE	Ecto-sp12_M_contig1025	Ecto-sp12_M_EVE1025-1	1	28565	V	28565	28564
Ectocarpus-sp12_MALE	Ecto-sp12_M_contig1964	Ecto-sp12_M_EVE1964-1	1	22351	V	22351	22350
Ectocarpus-sp12_MALE	Ecto-sp12_M_contig3455	Ecto-sp12_M_EVE3455-1	1	17551	V	17551	17550
Ectocarpus-sp12_MALE	Ecto-sp12_M_contig4591	Ecto-sp12_M_EVE4591-1	1	15398	V	15398	15397
Ectocarpus-sp12_MALE	Ecto-sp12_M_contig4914	Ecto-sp12_M_EVE4914-1	1	14914	V	14914	14913
Ectocarpus-sp12_MALE	Ecto-sp12_M_contig4947	Ecto-sp12_M_EVE4947-1	1	14870	V	14870	14869
Ectocarpus-sp12_MALE	Ecto-sp12_M_contig5181	Ecto-sp12_M_EVE5181-1	1	14514	V	14514	14513
Ectocarpus-sp12_MALE	Ecto-sp12_M_contig5487	Ecto-sp12_M_EVE5487-1	1	14103	V	14103	14102
Ectocarpus-sp12_MALE	Ecto-sp12_M_contig5929	Ecto-sp12_M_EVE5929-1	1	13506	V	13506	13505
Ectocarpus-sp12_MALE	Ecto-sp12_M_contig6253	Ecto-sp12_M_EVE6253-1	1	13124	V	13124	13123
Ectocarpus-sp12_MALE	Ecto-sp12_M_contig7172	Ecto-sp12_M_EVE7172-1	1	12138	V	12138	12137
Ectocarpus-sp12_MALE	Ecto-sp12_M_contig7243	Ecto-sp12_M_EVE7243-1	3000	6000	HVH	12076	3000
Ectocarpus-sp12_MALE	Ecto-sp12_M_contig7900	Ecto-sp12_M_EVE7900-1	4300	6900	HVH	11508	2600
Ectocarpus-sp12_MALE	Ecto-sp12_M_contig8485	Ecto-sp12_M_EVE8485-1	1	11026	V	11026	11025
Ectocarpus-sp12_MALE	Ecto-sp12_M_contig9349	Ecto-sp12_M_EVE9349-1	1	10395	V	10395	10394
Ectocarpus-sp12_MALE	Ecto-sp12_M_contig9748	Ecto-sp12_M_EVE9748-1	1	10102	V	10102	10101
Ectocarpus-sp12_MALE	Ecto-sp12_M_contig10726	Ecto-sp12_M_EVE10726-1	1	9476	V	9476	9475
Ectocarpus-sp12_MALE	Ecto-sp12_M_contig11740	Ecto-sp12_M_EVE11740-1	1	8875	V	8875	8874
Ectocarpus-sp12_MALE	Ecto-sp12_M_contig15856	Ecto-sp12_M_EVE15856-1	1	6988	V	6988	6987
Ectocarpus-sp12_MALE	Ecto-sp12_M_contig16540	Ecto-sp12_M_EVE16540-1	1	6718	V	6718	6717
Ectocarpus-sp12_MALE	Ecto-sp12_M_contig16761	Ecto-sp12_M_EVE16761-1	1	6634	V	6634	6633
Ectocarpus-sp12_MALE	Ecto-sp12_M_contig17551	Ecto-sp12_M_EVE17551-1	1	6345	V	6345	6344
Ectocarpus-sp12_MALE	Ecto-sp12_M_contig19436	Ecto-sp12_M_EVE19436-1	1	5756	V	5756	5755
Ectocarpus-sp12_MALE	Ecto-sp12_M_contig20919	Ecto-sp12_M_EVE20919-1	1	5359	V	5359	5358
Ectocarpus-sp12_MALE	Ecto-sp12_M_contig22550	Ecto-sp12_M_EVE22550-1	1	4961	V	4961	4960
Ectocarpus-sp12_MALE	Ecto-sp12_M_contig23208	Ecto-sp12_M_EVE23208-1	1	4814	V	4814	4813
Ectocarpus-sp12_MALE	Ecto-sp12_M_contig24570	Ecto-sp12_M_EVE24570-1	1	4528	V	4528	4527
Ectocarpus-sp12_MALE	Ecto-sp12_M_contig25153	Ecto-sp12_M_EVE25153-1	1	4418	V	4418	4417
Ectocarpus-sp12_MALE	Ecto-sp12_M_contig36240	Ecto-sp12_M_EVE36240-1	1	2676	V	2676	2675
Ectocarpus-sp13_MALE	Ecto-sp13_M_contig644	Ecto-sp13_M_EVE644-1	1	23035	V	23035	23034
Ectocarpus-sp13_MALE	Ecto-sp13_M_contig890	Ecto-sp13_M_EVE890-1	1	20777	V	20777	20776
Ectocarpus-sp13_MALE	Ecto-sp13_M_contig2353	Ecto-sp13_M_EVE2353-1	1	14015	V	14015	14014
Ectocarpus-sp13_MALE	Ecto-sp13_M_contig2749	Ecto-sp13_M_EVE2749-1	1	13062	V	13062	13061
Ectocarpus-sp13_MALE	Ecto-sp13_M_contig3024	Ecto-sp13_M_EVE3024-1	1	12472	V	12472	12471
Ectocarpus-sp13_MALE	Ecto-sp13_M_contig3562	Ecto-sp13_M_EVE3562-1	1	11539	V	11539	11538
Ectocarpus-sp13_MALE	Ecto-sp13_M_contig4260	Ecto-sp13_M_EVE4260-1	1	10454	V	10454	10453
Ectocarpus-sp13_MALE	Ecto-sp13_M_contig5852	Ecto-sp13_M_EVE5852-1	1	8771	V	8771	8770
Ectocarpus-sp13_MALE	Ecto-sp13_M_contig6035	Ecto-sp13_M_EVE6035-1	1	8589	V	8589	8588
Ectocarpus-sp13_MALE	Ecto-sp13_M_contig6953	Ecto-sp13_M_EVE6953-1	1	7857	V	7857	7856
Ectocarpus-sp13_MALE	Ecto-sp13_M_contig7043	Ecto-sp13_M_EVE7043-1	1	7789	V	7789	7788
Ectocarpus-sp13_MALE	Ecto-sp13_M_contig7413	Ecto-sp13_M_EVE7413-1	1	7522	V	7522	7521
Ectocarpus-sp13_MALE	Ecto-sp13_M_contig7582	Ecto-sp13_M_EVE7582-1	1	7403	V	7403	7402
Ectocarpus-sp13_MALE	Ecto-sp13_M_contig10594	Ecto-sp13_M_EVE10594-1	1	5766	V	5766	5765
Ectocarpus-sp13_MALE	Ecto-sp13_M_contig11988	Ecto-sp13_M_EVE11988-1	1	5222	V	5222	5221
Ectocarpus-sp13_MALE	Ecto-sp13_M_contig12245	Ecto-sp13_M_EVE12245-1	1	5129	V	5129	5128
Ectocarpus-sp13_MALE	Ecto-sp13_M_contig12639	Ecto-sp13_M_EVE12639-1	1	4983	V	4983	4982
Ectocarpus-sp13_MALE	Ecto-sp13_M_contig13236	Ecto-sp13_M_EVE13236-1	1	4787	V	4787	4786
Ectocarpus-sp13_MALE	Ecto-sp13_M_contig13239	Ecto-sp13_M_EVE13239-1	1	4785	V	4785	4784
Ectocarpus-sp13_MALE	Ecto-sp13_M_contig15801	Ecto-sp13_M_EVE15801-1	1	4070	V	4070	4069
Ectocarpus-sp13_MALE	Ecto-sp13_M_contig15932	Ecto-sp13_M_EVE15932-1	1	4032	V	4032	4031
Ectocarpus-sp13_MALE	Ecto-sp13_M_contig15951	Ecto-sp13_M_EVE15951-1	1	4028	V	4028	4027
Feldmannia-mitchelliae	F-mitchelliae_contig239	F-mitchelliae_EVE239-1	1	68977	V	68977	68976
Feldmannia-mitchelliae	F-mitchelliae_contig415	F-mitchelliae_EVE415-1	1	57025	V	57025	57024
Feldmannia-mitchelliae	F-mitchelliae_contig467	F-mitchelliae_EVE467-1	1	54167	V	54167	54166
Feldmannia-mitchelliae	F-mitchelliae_contig776	F-mitchelliae_EVE776-1	1	43606	V	43606	43605
Feldmannia-mitchelliae	F-mitchelliae_contig877	F-mitchelliae_EVE877-1	1	40955	V	40955	40954
Feldmannia-mitchelliae	F-mitchelliae_contig1012	F-mitchelliae_EVE1012-1	1	37851	V	37851	37850
Feldmannia-mitchelliae	F-mitchelliae_contig1742	F-mitchelliae_EVE1742-1	1	28092	V	28092	28091
Feldmannia-mitchelliae	F-mitchelliae_contig2044	F-mitchelliae_EVE2044-1	1	25265	V	25265	25264
Feldmannia-mitchelliae	F-mitchelliae_contig2182	F-mitchelliae_EVE2182-1	1	24325	V	24325	24324
Feldmannia-mitchelliae	F-mitchelliae_contig2242	F-mitchelliae_EVE2242-1	1	23810	V	23810	23809
Feldmannia-mitchelliae	F-mitchelliae_contig2366	F-mitchelliae_EVE2366-1	1	22900	V	22900	22899
Feldmannia-mitchelliae	F-mitchelliae_contig2505	F-mitchelliae_EVE2505-1	1	22078	V	22078	22077
Feldmannia-mitchelliae	F-mitchelliae_contig2527	F-mitchelliae_EVE2527-1	1700	21892	HV	21892	20192
Feldmannia-mitchelliae	F-mitchelliae_contig2996	F-mitchelliae_EVE2996-1	1	18999	V	18999	18998
Feldmannia-mitchelliae	F-mitchelliae_contig3030	F-mitchelliae_EVE3030-1	1	18833	V	18833	18832
Feldmannia-mitchelliae	F-mitchelliae_contig3292	F-mitchelliae_EVE3292-1	1	17575	V	17575	17574
Feldmannia-mitchelliae	F-mitchelliae_contig3599	F-mitchelliae_EVE3599-1	1	16180	V	16180	16179
Feldmannia-mitchelliae	F-mitchelliae_contig3616	F-mitchelliae_EVE3616-1	1	16110	V	16110	16109
Feldmannia-mitchelliae	F-mitchelliae_contig3672	F-mitchelliae_EVE3672-1	1	15909	V	15909	15908
Feldmannia-mitchelliae	F-mitchelliae_contig3985	F-mitchelliae_EVE3985-1	1	14704	V	14704	14703
Feldmannia-mitchelliae	F-mitchelliae_contig4048	F-mitchelliae_EVE4048-1	1	14469	V	14469	14468
Feldmannia-mitchelliae	F-mitchelliae_contig4055	F-mitchelliae_EVE4055-1	1	14459	V	14459	14458
Feldmannia-mitchelliae	F-mitchelliae_contig4123	F-mitchelliae_EVE4123-1	1	14242	V	14242	14241
Feldmannia-mitchelliae	F-mitchelliae_contig4153	F-mitchelliae_EVE4153-1	1	14125	V	14125	14124
Feldmannia-mitchelliae	F-mitchelliae_contig4776	F-mitchelliae_EVE4776-1	1	12158	V	12158	12157
Feldmannia-mitchelliae	F-mitchelliae_contig5010	F-mitchelliae_EVE5010-1	1	11526	V	11526	11525
Feldmannia-mitchelliae	F-mitchelliae_contig5089	F-mitchelliae_EVE5089-1	1	11354	V	11354	11353
Feldmannia-mitchelliae	F-mitchelliae_contig5417	F-mitchelliae_EVE5417-1	1	10409	V	10409	10408
Feldmannia-mitchelliae	F-mitchelliae_contig5570	F-mitchelliae_EVE5570-1	1	10056	V	10056	10055
Feldmannia-mitchelliae	F-mitchelliae_contig6005	F-mitchelliae_EVE6005-1	1	9067	V	9067	9066
Feldmannia-mitchelliae	F-mitchelliae_contig6099	F-mitchelliae_EVE6099-1	1	8897	V	8897	8896
Feldmannia-mitchelliae	F-mitchelliae_contig6227	F-mitchelliae_EVE6227-1	1	8631	V	8631	8630
Feldmannia-mitchelliae	F-mitchelliae_contig6850	F-mitchelliae_EVE6850-1	1	7530	V	7530	7529
Feldmannia-mitchelliae	F-mitchelliae_contig6857	F-mitchelliae_EVE6857-1	1	7521	V	7521	7520
Feldmannia-mitchelliae	F-mitchelliae_contig7187	F-mitchelliae_EVE7187-1	1	7073	V	7073	7072
Feldmannia-mitchelliae	F-mitchelliae_contig8015	F-mitchelliae_EVE8015-1	1	5990	V	5990	5989
Feldmannia-mitchelliae	F-mitchelliae_contig9023	F-mitchelliae_EVE9023-1	1	4980	V	4980	4979
Feldmannia-mitchelliae	F-mitchelliae_contig9179	F-mitchelliae_EVE9179-1	1	4827	V	4827	4826
Feldmannia-mitchelliae	F-mitchelliae_contig9495	F-mitchelliae_EVE9495-1	1	4560	V	4560	4559
Feldmannia-mitchelliae	F-mitchelliae_contig9645	F-mitchelliae_EVE9645-1	1	4450	V	4450	4449
Feldmannia-mitchelliae	F-mitchelliae_contig10118	F-mitchelliae_EVE10118-1	1	4062	V	4062	4061
Feldmannia-mitchelliae	F-mitchelliae_contig10214	F-mitchelliae_EVE10214-1	1	3990	V	3990	3989
Feldmannia-mitchelliae	F-mitchelliae_contig11473	F-mitchelliae_EVE11473-1	1	3174	V	3174	3173
Fucus-distichus	F-distichus_contig173	F-distichus_EVE173-1	1	34240	V	34240	34239
Fucus-distichus	F-distichus_contig331	F-distichus_EVE331-1	1	30359	V	30359	30358
Fucus-distichus	F-distichus_contig483	F-distichus_EVE483-1	1	28223	V	28223	28222
Fucus-distichus	F-distichus_contig10503	F-distichus_EVE10503-1	1	10984	V	10984	10983
Fucus-distichus	F-distichus_contig13488	F-distichus_EVE13488-1	1	9789	V	9789	9788
Fucus-distichus	F-distichus_contig20779	F-distichus_EVE20779-1	1	7846	V	7846	7845
Fucus-serratus_MALE	F-serratus_M_contig29	F-serratus_M_EVE29-1	788000	1038000	HVH	1198156	250000
Fucus-serratus_MALE	F-serratus_M_contig931	F-serratus_M_EVE931-1	178000	203000	HVH	344627	25000
Fucus-serratus_MALE	F-serratus_M_contig2219	F-serratus_M_EVE2219-1	1	10000	HV	166015	9999
Fucus-serratus_MALE	F-serratus_M_contig5825	F-serratus_M_EVE5825-1	5000	18000	HVH	45122	13000
Halopteris-paniculata	H-paniculata_contig1122	H-paniculata_EVE1122-1	3000	10500	HVH	29028	7500
Halopteris-paniculata	H-paniculata_contig11721	H-paniculata_EVE11721-1	1	8090	V	8090	8089
Heribaudiella-fluviatilis	H-fluviatilis_contig1	H-fluviatilis_EVE1-1	142200	159200	HVH	440421	17000
Heribaudiella-fluviatilis	H-fluviatilis_contig5	H-fluviatilis_EVE5-1	1	26000	HV	221079	25999
Heribaudiella-fluviatilis	H-fluviatilis_contig29	H-fluviatilis_EVE29-1	1	115858	V	115858	115857
Heribaudiella-fluviatilis	H-fluviatilis_contig33	H-fluviatilis_EVE33-1	1	110398	V	110398	110397
Heribaudiella-fluviatilis	H-fluviatilis_contig53	H-fluviatilis_EVE53-1	7600	85537	HV	85537	77937
Heribaudiella-fluviatilis	H-fluviatilis_contig60	H-fluviatilis_EVE60-1	1	81143	V	81143	81142
Heribaudiella-fluviatilis	H-fluviatilis_contig80	H-fluviatilis_EVE80-1	1	71692	V	71692	71691
Heribaudiella-fluviatilis	H-fluviatilis_contig89	H-fluviatilis_EVE89-1	1	68300	V	68300	68299
Heribaudiella-fluviatilis	H-fluviatilis_contig97	H-fluviatilis_EVE97-1	1	66369	V	66369	66368
Heribaudiella-fluviatilis	H-fluviatilis_contig100	H-fluviatilis_EVE100-1	1	65998	V	65998	65997
Heribaudiella-fluviatilis	H-fluviatilis_contig102	H-fluviatilis_EVE102-1	30500	65471	HV	65471	34971
Heribaudiella-fluviatilis	H-fluviatilis_contig149	H-fluviatilis_EVE149-1	3580	53883	HV	53883	50303
Heribaudiella-fluviatilis	H-fluviatilis_contig151	H-fluviatilis_EVE151-1	1	53430	V	53430	53429
Heribaudiella-fluviatilis	H-fluviatilis_contig162	H-fluviatilis_EVE162-1	1	50995	V	50995	50994
Heribaudiella-fluviatilis	H-fluviatilis_contig173	H-fluviatilis_EVE173-1	1	35000	HV	49588	34999
Heribaudiella-fluviatilis	H-fluviatilis_contig191	H-fluviatilis_EVE191-1	1	20000	HV	47663	19999
Heribaudiella-fluviatilis	H-fluviatilis_contig209	H-fluviatilis_EVE209-1	1	45112	V	45112	45111
Heribaudiella-fluviatilis	H-fluviatilis_contig214	H-fluviatilis_EVE214-1	1	38000	HV	44672	37999
Heribaudiella-fluviatilis	H-fluviatilis_contig258	H-fluviatilis_EVE258-1	23000	41891	HV	41891	18891
Heribaudiella-fluviatilis	H-fluviatilis_contig284	H-fluviatilis_EVE284-1	1	26000	HV	40071	25999
Heribaudiella-fluviatilis	H-fluviatilis_contig348	H-fluviatilis_EVE348-1	10500	36392	HV	36392	25892
Heribaudiella-fluviatilis	H-fluviatilis_contig367	H-fluviatilis_EVE367-1	1	35585	V	35585	35584
Heribaudiella-fluviatilis	H-fluviatilis_contig373	H-fluviatilis_EVE373-1	1	35276	V	35276	35275
Heribaudiella-fluviatilis	H-fluviatilis_contig611	H-fluviatilis_EVE611-1	10000	29102	HV	29102	19102
Heribaudiella-fluviatilis	H-fluviatilis_contig723	H-fluviatilis_EVE723-1	2000	27137	HV	27137	25137
Heribaudiella-fluviatilis	H-fluviatilis_contig760	H-fluviatilis_EVE760-1	1	26565	V	26565	26564
Heribaudiella-fluviatilis	H-fluviatilis_contig761	H-fluviatilis_EVE761-1	1	26565	V	26565	26564
Heribaudiella-fluviatilis	H-fluviatilis_contig762	H-fluviatilis_EVE762-1	1	26537	V	26537	26536
Heribaudiella-fluviatilis	H-fluviatilis_contig795	H-fluviatilis_EVE795-1	1	20500	HV	26201	20499
Heribaudiella-fluviatilis	H-fluviatilis_contig920	H-fluviatilis_EVE920-1	1	24874	V	24874	24873
Heribaudiella-fluviatilis	H-fluviatilis_contig1344	H-fluviatilis_EVE1344-1	1	21502	V	21502	21501
Heribaudiella-fluviatilis	H-fluviatilis_contig1529	H-fluviatilis_EVE1529-1	1	20418	V	20418	20417
Heribaudiella-fluviatilis	H-fluviatilis_contig1889	H-fluviatilis_EVE1889-1	1	18756	V	18756	18755
Heribaudiella-fluviatilis	H-fluviatilis_contig2007	H-fluviatilis_EVE2007-1	1	18261	V	18261	18260
Heribaudiella-fluviatilis	H-fluviatilis_contig2065	H-fluviatilis_EVE2065-1	1	18028	V	18028	18027
Heribaudiella-fluviatilis	H-fluviatilis_contig2461	H-fluviatilis_EVE2461-1	1	16793	V	16793	16792
Heribaudiella-fluviatilis	H-fluviatilis_contig2491	H-fluviatilis_EVE2491-1	1	16708	V	16708	16707
Heribaudiella-fluviatilis	H-fluviatilis_contig3437	H-fluviatilis_EVE3437-1	1	14511	V	14511	14510
Heribaudiella-fluviatilis	H-fluviatilis_contig3700	H-fluviatilis_EVE3700-1	1	14012	V	14012	14011
Heribaudiella-fluviatilis	H-fluviatilis_contig4250	H-fluviatilis_EVE4250-1	1	13139	V	13139	13138
Heribaudiella-fluviatilis	H-fluviatilis_contig4507	H-fluviatilis_EVE4507-1	5600	12801	HV	12801	7201
Heribaudiella-fluviatilis	H-fluviatilis_contig5101	H-fluviatilis_EVE5101-1	1	12077	V	12077	12076
Heribaudiella-fluviatilis	H-fluviatilis_contig5331	H-fluviatilis_EVE5331-1	1	11809	V	11809	11808
Heribaudiella-fluviatilis	H-fluviatilis_contig8970	H-fluviatilis_EVE8970-1	1	8788	V	8788	8787
Heribaudiella-fluviatilis	H-fluviatilis_contig9025	H-fluviatilis_EVE9025-1	1	8747	V	8747	8746
Heribaudiella-fluviatilis	H-fluviatilis_contig9559	H-fluviatilis_EVE9559-1	1	8445	V	8445	8444
Heribaudiella-fluviatilis	H-fluviatilis_contig10997	H-fluviatilis_EVE10997-1	1	7729	V	7729	7728
Heribaudiella-fluviatilis	H-fluviatilis_contig15116	H-fluviatilis_EVE15116-1	1	6209	V	6209	6208
Heribaudiella-fluviatilis	H-fluviatilis_contig25254	H-fluviatilis_EVE25254-1	1	4089	V	4089	4088
Laminarionema-elsbetiae	L-elsbetiae_contig101	L-elsbetiae_EVE101-1	1	58838	V	58838	58837
Laminarionema-elsbetiae	L-elsbetiae_contig177	L-elsbetiae_EVE177-1	1	52489	V	52489	52488
Laminarionema-elsbetiae	L-elsbetiae_contig211	L-elsbetiae_EVE211-1	1	50425	V	50425	50424
Laminarionema-elsbetiae	L-elsbetiae_contig1189	L-elsbetiae_EVE1189-1	1	28304	V	28304	28303
Laminarionema-elsbetiae	L-elsbetiae_contig1531	L-elsbetiae_EVE1531-1	1	25655	V	25655	25654
Laminarionema-elsbetiae	L-elsbetiae_contig1626	L-elsbetiae_EVE1626-1	12500	18500	HVH	24972	6000
Laminarionema-elsbetiae	L-elsbetiae_contig1856	L-elsbetiae_EVE1856-1	1	23308	V	23308	23307
Laminarionema-elsbetiae	L-elsbetiae_contig2312	L-elsbetiae_EVE2312-1	1	20963	V	20963	20962
Laminarionema-elsbetiae	L-elsbetiae_contig2558	L-elsbetiae_EVE2558-1	1	20109	V	20109	20108
Laminarionema-elsbetiae	L-elsbetiae_contig2578	L-elsbetiae_EVE2578-1	1	20014	V	20014	20013
Laminarionema-elsbetiae	L-elsbetiae_contig2970	L-elsbetiae_EVE2970-1	1	18510	V	18510	18509
Laminarionema-elsbetiae	L-elsbetiae_contig3407	L-elsbetiae_EVE3407-1	1	17021	V	17021	17020
Laminarionema-elsbetiae	L-elsbetiae_contig3629	L-elsbetiae_EVE3629-1	8700	16456	HV	16456	7756
Laminarionema-elsbetiae	L-elsbetiae_contig4780	L-elsbetiae_EVE4780-1	1	13821	V	13821	13820
Laminarionema-elsbetiae	L-elsbetiae_contig4973	L-elsbetiae_EVE4973-1	1	13450	V	13450	13449
Laminarionema-elsbetiae	L-elsbetiae_contig6266	L-elsbetiae_EVE6266-1	1	11351	V	11351	11350
Laminarionema-elsbetiae	L-elsbetiae_contig9332	L-elsbetiae_EVE9332-1	1	7882	V	7882	7881
Macrocystis-pyrifera_MALE	M-pyrifera_M_contig942	M-pyrifera_M_EVE942-1	1	30994	V	30994	30993
Macrocystis-pyrifera_MALE	M-pyrifera_M_contig1827	M-pyrifera_M_EVE1827-1	1	24684	V	24684	24683
Macrocystis-pyrifera_MALE	M-pyrifera_M_contig5688	M-pyrifera_M_EVE5688-1	1	14934	V	14934	14933
Myriotrichia-clavaeformis_FEMALE	M-clavaeformis_F_contig2	M-clavaeformis_F_EVE2-1	1	183262	V	183262	183261
Myriotrichia-clavaeformis_FEMALE	M-clavaeformis_F_contig7	M-clavaeformis_F_EVE7-1	1	145114	V	145114	145113
Myriotrichia-clavaeformis_FEMALE	M-clavaeformis_F_contig24	M-clavaeformis_F_EVE24-1	1	109706	V	109706	109705
Myriotrichia-clavaeformis_FEMALE	M-clavaeformis_F_contig97	M-clavaeformis_F_EVE97-1	1	82436	V	82436	82435
Myriotrichia-clavaeformis_FEMALE	M-clavaeformis_F_contig104	M-clavaeformis_F_EVE104-1	1	80562	V	80562	80561
Myriotrichia-clavaeformis_FEMALE	M-clavaeformis_F_contig185	M-clavaeformis_F_EVE185-1	41500	69040	HV	69040	27540
Myriotrichia-clavaeformis_FEMALE	M-clavaeformis_F_contig234	M-clavaeformis_F_EVE234-1	1	61994	V	61994	61993
Myriotrichia-clavaeformis_FEMALE	M-clavaeformis_F_contig290	M-clavaeformis_F_EVE290-1	1	57451	V	57451	57450
Myriotrichia-clavaeformis_FEMALE	M-clavaeformis_F_contig459	M-clavaeformis_F_EVE459-1	1	48527	V	48527	48526
Myriotrichia-clavaeformis_FEMALE	M-clavaeformis_F_contig480	M-clavaeformis_F_EVE480-1	1	42000	HV	47770	41999
Myriotrichia-clavaeformis_FEMALE	M-clavaeformis_F_contig520	M-clavaeformis_F_EVE520-1	11000	46284	HV	46284	35284
Myriotrichia-clavaeformis_FEMALE	M-clavaeformis_F_contig601	M-clavaeformis_F_EVE601-1	1	44019	V	44019	44018
Myriotrichia-clavaeformis_FEMALE	M-clavaeformis_F_contig625	M-clavaeformis_F_EVE625-1	1	43344	V	43344	43343
Myriotrichia-clavaeformis_FEMALE	M-clavaeformis_F_contig633	M-clavaeformis_F_EVE633-1	1	43239	V	43239	43238
Myriotrichia-clavaeformis_FEMALE	M-clavaeformis_F_contig707	M-clavaeformis_F_EVE707-1	1	41293	V	41293	41292
Myriotrichia-clavaeformis_FEMALE	M-clavaeformis_F_contig737	M-clavaeformis_F_EVE737-1	1	40424	V	40424	40423
Myriotrichia-clavaeformis_FEMALE	M-clavaeformis_F_contig948	M-clavaeformis_F_EVE948-1	17500	35251	HV	35251	17751
Myriotrichia-clavaeformis_FEMALE	M-clavaeformis_F_contig952	M-clavaeformis_F_EVE952-1	1	31000	HV	35208	30999
Myriotrichia-clavaeformis_FEMALE	M-clavaeformis_F_contig1081	M-clavaeformis_F_EVE1081-1	1	32758	V	32758	32757
Myriotrichia-clavaeformis_FEMALE	M-clavaeformis_F_contig1127	M-clavaeformis_F_EVE1127-1	1	31997	V	31997	31996
Myriotrichia-clavaeformis_FEMALE	M-clavaeformis_F_contig1375	M-clavaeformis_F_EVE1375-1	1	28519	V	28519	28518
Myriotrichia-clavaeformis_FEMALE	M-clavaeformis_F_contig1399	M-clavaeformis_F_EVE1399-1	1	28199	V	28199	28198
Myriotrichia-clavaeformis_FEMALE	M-clavaeformis_F_contig1497	M-clavaeformis_F_EVE1497-1	1	26997	V	26997	26996
Myriotrichia-clavaeformis_FEMALE	M-clavaeformis_F_contig1588	M-clavaeformis_F_EVE1588-1	1	25831	V	25831	25830
Myriotrichia-clavaeformis_FEMALE	M-clavaeformis_F_contig1641	M-clavaeformis_F_EVE1641-1	1	25134	V	25134	25133
Myriotrichia-clavaeformis_FEMALE	M-clavaeformis_F_contig1676	M-clavaeformis_F_EVE1676-1	1	24766	V	24766	24765
Myriotrichia-clavaeformis_FEMALE	M-clavaeformis_F_contig1755	M-clavaeformis_F_EVE1755-1	1	23944	V	23944	23943
Myriotrichia-clavaeformis_FEMALE	M-clavaeformis_F_contig1870	M-clavaeformis_F_EVE1870-1	1	22913	V	22913	22912
Myriotrichia-clavaeformis_FEMALE	M-clavaeformis_F_contig1921	M-clavaeformis_F_EVE1921-1	1	22428	V	22428	22427
Myriotrichia-clavaeformis_FEMALE	M-clavaeformis_F_contig2146	M-clavaeformis_F_EVE2146-1	1	20415	V	20415	20414
Myriotrichia-clavaeformis_FEMALE	M-clavaeformis_F_contig2704	M-clavaeformis_F_EVE2704-1	1	16467	V	16467	16466
Myriotrichia-clavaeformis_FEMALE	M-clavaeformis_F_contig3071	M-clavaeformis_F_EVE3071-1	1	14329	V	14329	14328
Myriotrichia-clavaeformis_FEMALE	M-clavaeformis_F_contig3231	M-clavaeformis_F_EVE3231-1	1	13520	V	13520	13519
Myriotrichia-clavaeformis_FEMALE	M-clavaeformis_F_contig3387	M-clavaeformis_F_EVE3387-1	1	12739	V	12739	12738
Myriotrichia-clavaeformis_FEMALE	M-clavaeformis_F_contig3802	M-clavaeformis_F_EVE3802-1	1	10948	V	10948	10947
Myriotrichia-clavaeformis_FEMALE	M-clavaeformis_F_contig4247	M-clavaeformis_F_EVE4247-1	1	9410	V	9410	9409
Myriotrichia-clavaeformis_FEMALE	M-clavaeformis_F_contig4289	M-clavaeformis_F_EVE4289-1	1	9307	V	9307	9306
Myriotrichia-clavaeformis_FEMALE	M-clavaeformis_F_contig4324	M-clavaeformis_F_EVE4324-1	1	9205	V	9205	9204
Myriotrichia-clavaeformis_FEMALE	M-clavaeformis_F_contig4714	M-clavaeformis_F_EVE4714-1	1	8038	V	8038	8037
Myriotrichia-clavaeformis_FEMALE	M-clavaeformis_F_contig4953	M-clavaeformis_F_EVE4953-1	1	7444	V	7444	7443
Myriotrichia-clavaeformis_FEMALE	M-clavaeformis_F_contig5213	M-clavaeformis_F_EVE5213-1	1	6769	V	6769	6768
Myriotrichia-clavaeformis_FEMALE	M-clavaeformis_F_contig5274	M-clavaeformis_F_EVE5274-1	1	6611	V	6611	6610
Myriotrichia-clavaeformis_FEMALE	M-clavaeformis_F_contig5433	M-clavaeformis_F_EVE5433-1	1	6265	V	6265	6264
Myriotrichia-clavaeformis_FEMALE	M-clavaeformis_F_contig5474	M-clavaeformis_F_EVE5474-1	1	6184	V	6184	6183
Myriotrichia-clavaeformis_FEMALE	M-clavaeformis_F_contig5640	M-clavaeformis_F_EVE5640-1	1	5845	V	5845	5844
Myriotrichia-clavaeformis_FEMALE	M-clavaeformis_F_contig5902	M-clavaeformis_F_EVE5902-1	1	5363	V	5363	5362
Myriotrichia-clavaeformis_FEMALE	M-clavaeformis_F_contig6040	M-clavaeformis_F_EVE6040-1	1	5116	V	5116	5115
Myriotrichia-clavaeformis_FEMALE	M-clavaeformis_F_contig6056	M-clavaeformis_F_EVE6056-1	1	5087	V	5087	5086
Myriotrichia-clavaeformis_FEMALE	M-clavaeformis_F_contig6072	M-clavaeformis_F_EVE6072-1	1	5065	V	5065	5064
Myriotrichia-clavaeformis_FEMALE	M-clavaeformis_F_contig6107	M-clavaeformis_F_EVE6107-1	1	5019	V	5019	5018
Myriotrichia-clavaeformis_FEMALE	M-clavaeformis_F_contig6219	M-clavaeformis_F_EVE6219-1	1	4804	V	4804	4803
Myriotrichia-clavaeformis_FEMALE	M-clavaeformis_F_contig6220	M-clavaeformis_F_EVE6220-1	1	4804	V	4804	4803
Myriotrichia-clavaeformis_FEMALE	M-clavaeformis_F_contig6232	M-clavaeformis_F_EVE6232-1	1	4780	V	4780	4779
Myriotrichia-clavaeformis_FEMALE	M-clavaeformis_F_contig6236	M-clavaeformis_F_EVE6236-1	1	4774	V	4774	4773
Myriotrichia-clavaeformis_FEMALE	M-clavaeformis_F_contig6497	M-clavaeformis_F_EVE6497-1	1	4336	V	4336	4335
Myriotrichia-clavaeformis_FEMALE	M-clavaeformis_F_contig6501	M-clavaeformis_F_EVE6501-1	1	4332	V	4332	4331
Myriotrichia-clavaeformis_FEMALE	M-clavaeformis_F_contig7038	M-clavaeformis_F_EVE7038-1	1	3598	V	3598	3597
Myriotrichia-clavaeformis_FEMALE	M-clavaeformis_F_contig7055	M-clavaeformis_F_EVE7055-1	1	3583	V	3583	3582
Myriotrichia-clavaeformis_FEMALE	M-clavaeformis_F_contig7065	M-clavaeformis_F_EVE7065-1	1	3570	V	3570	3569
Myriotrichia-clavaeformis_FEMALE	M-clavaeformis_F_contig7146	M-clavaeformis_F_EVE7146-1	1	3476	V	3476	3475
Myriotrichia-clavaeformis_FEMALE	M-clavaeformis_F_contig7475	M-clavaeformis_F_EVE7475-1	1	3156	V	3156	3155
Myriotrichia-clavaeformis_FEMALE	M-clavaeformis_F_contig7476	M-clavaeformis_F_EVE7476-1	1	3153	V	3153	3152
Myriotrichia-clavaeformis_FEMALE	M-clavaeformis_F_contig7726	M-clavaeformis_F_EVE7726-1	1	2888	V	2888	2887
Myriotrichia-clavaeformis_FEMALE	M-clavaeformis_F_contig8048	M-clavaeformis_F_EVE8048-1	1	2605	V	2605	2604
Myriotrichia-clavaeformis_FEMALE	M-clavaeformis_F_contig8367	M-clavaeformis_F_EVE8367-1	1	2376	V	2376	2375
Myriotrichia-clavaeformis_FEMALE	M-clavaeformis_F_contig9188	M-clavaeformis_F_EVE9188-1	1	1894	V	1894	1893
Myriotrichia-clavaeformis_FEMALE	M-clavaeformis_F_contig9421	M-clavaeformis_F_EVE9421-1	1	1793	V	1793	1792
Myriotrichia-clavaeformis_FEMALE	M-clavaeformis_F_contig9431	M-clavaeformis_F_EVE9431-1	1	1787	V	1787	1786
Myriotrichia-clavaeformis_FEMALE	M-clavaeformis_F_contig9445	M-clavaeformis_F_EVE9445-1	1	1781	V	1781	1780
Myriotrichia-clavaeformis_FEMALE	M-clavaeformis_F_contig10042	M-clavaeformis_F_EVE10042-1	1	1540	V	1540	1539
Myriotrichia-clavaeformis_FEMALE	M-clavaeformis_F_contig10507	M-clavaeformis_F_EVE10507-1	1	1377	V	1377	1376
Myriotrichia-clavaeformis_FEMALE	M-clavaeformis_F_contig10561	M-clavaeformis_F_EVE10561-1	1	1358	V	1358	1357
Myriotrichia-clavaeformis_MALE	M-clavaeformis_M_contig14	M-clavaeformis_M_EVE14-1	1	145438	V	145438	145437
Myriotrichia-clavaeformis_MALE	M-clavaeformis_M_contig41	M-clavaeformis_M_EVE41-1	1	113515	V	113515	113514
Myriotrichia-clavaeformis_MALE	M-clavaeformis_M_contig48	M-clavaeformis_M_EVE48-1	1	110031	V	110031	110030
Myriotrichia-clavaeformis_MALE	M-clavaeformis_M_contig137	M-clavaeformis_M_EVE137-1	1	80629	V	80629	80628
Myriotrichia-clavaeformis_MALE	M-clavaeformis_M_contig138	M-clavaeformis_M_EVE138-1	1	80618	V	80618	80617
Myriotrichia-clavaeformis_MALE	M-clavaeformis_M_contig215	M-clavaeformis_M_EVE215-1	1	70626	V	70626	70625
Myriotrichia-clavaeformis_MALE	M-clavaeformis_M_contig258	M-clavaeformis_M_EVE258-1	1	66031	V	66031	66030
Myriotrichia-clavaeformis_MALE	M-clavaeformis_M_contig307	M-clavaeformis_M_EVE307-1	1	62332	V	62332	62331
Myriotrichia-clavaeformis_MALE	M-clavaeformis_M_contig428	M-clavaeformis_M_EVE428-1	1	48300	HV	54915	48299
Myriotrichia-clavaeformis_MALE	M-clavaeformis_M_contig592	M-clavaeformis_M_EVE592-1	1	47271	V	47271	47270
Myriotrichia-clavaeformis_MALE	M-clavaeformis_M_contig643	M-clavaeformis_M_EVE643-1	1	45315	V	45315	45314
Myriotrichia-clavaeformis_MALE	M-clavaeformis_M_contig724	M-clavaeformis_M_EVE724-1	1	42762	V	42762	42761
Myriotrichia-clavaeformis_MALE	M-clavaeformis_M_contig750	M-clavaeformis_M_EVE750-1	1	41951	V	41951	41950
Myriotrichia-clavaeformis_MALE	M-clavaeformis_M_contig807	M-clavaeformis_M_EVE807-1	1	40434	V	40434	40433
Myriotrichia-clavaeformis_MALE	M-clavaeformis_M_contig1232	M-clavaeformis_M_EVE1232-1	1	31905	V	31905	31904
Myriotrichia-clavaeformis_MALE	M-clavaeformis_M_contig1235	M-clavaeformis_M_EVE1235-1	1	31837	V	31837	31836
Myriotrichia-clavaeformis_MALE	M-clavaeformis_M_contig1344	M-clavaeformis_M_EVE1344-1	1	30047	V	30047	30046
Myriotrichia-clavaeformis_MALE	M-clavaeformis_M_contig1495	M-clavaeformis_M_EVE1495-1	1	28167	V	28167	28166
Myriotrichia-clavaeformis_MALE	M-clavaeformis_M_contig1541	M-clavaeformis_M_EVE1541-1	1	27595	V	27595	27594
Myriotrichia-clavaeformis_MALE	M-clavaeformis_M_contig1704	M-clavaeformis_M_EVE1704-1	1	25385	V	25385	25384
Myriotrichia-clavaeformis_MALE	M-clavaeformis_M_contig2905	M-clavaeformis_M_EVE2905-1	1	15260	V	15260	15259
Pelvetia-canaliculata	P-canaliculata_contig3	P-canaliculata_EVE3-1	1	150870	V	150870	150869
Pelvetia-canaliculata	P-canaliculata_contig4	P-canaliculata_EVE4-1	50000	77500	HVH	143237	27500
Pleurocladia-lacustris	P-lacustris_contig29	P-lacustris_EVE29-1	156000	171000	HVH	362780	15000
Pleurocladia-lacustris	P-lacustris_contig30	P-lacustris_EVE30-1	276000	284500	HVH	358783	8500
Pleurocladia-lacustris	P-lacustris_contig351	P-lacustris_EVE351-1	92000	101000	HVH	152105	9000
Pleurocladia-lacustris	P-lacustris_contig444	P-lacustris_EVE444-1	100000	116000	HVH	133644	16000
Porterinema-fluviatile	P-fluviatile_contig7	P-fluviatile_EVE7-1	3498000	3815000	HVH	4035589	317000
Porterinema-fluviatile	P-fluviatile_contig12	P-fluviatile_EVE12-1	22000	345000	HVH	3611420	323000
Porterinema-fluviatile	P-fluviatile_contig21	P-fluviatile_EVE21-1	297000	414000	HVH	2693707	117000
Porterinema-fluviatile	P-fluviatile_contig22	P-fluviatile_EVE22-1	1209000	1454000	HVH	2616382	245000
Porterinema-fluviatile	P-fluviatile_contig40	P-fluviatile_EVE40-2	220000	248000	HVH	1695800	28000
Porterinema-fluviatile	P-fluviatile_contig40	P-fluviatile_EVE40-1	1557000	1695800	HV	1695800	138800
Porterinema-fluviatile	P-fluviatile_contig94	P-fluviatile_EVE94-1	43000	85000	HVH	92372	42000
PUBLIC_Cladosiphon-okamuranus	scaffold223	EVE223-1	1	200000	HV	213198	199999
PUBLIC_Cladosiphon-okamuranus	scaffold296	EVE296-1	24000	147625	HV	147625	123625
PUBLIC_Ectocarpus-sp7	chr_06	EVE06-1	4219182	4552732	HVH	8757758	333550
PUBLIC_Ectocarpus-subulatus	Scaffold_172	EVE172-1	28000	40000	HVH	290160	12000
PUBLIC_Ectocarpus-subulatus	Scaffold_194	EVE194-1	45000	72000	HVH	1811928	27000
PUBLIC_Ectocarpus-subulatus	Scaffold_557	EVE557-1	504000	590000	HVH	690101	86000
PUBLIC_Nemacystus-decipiens	scaffold27_size3167232	EVE27_size3167232-1	1	150000	HV	3173888	149999
PUBLIC_Nemacystus-decipiens	scaffold167_size90808	EVE167_size90808-1	1	91292	V	91292	91291
PUBLIC_Nemacystus-decipiens	scaffold212_size40883	EVE212_size40883-1	1	34000	HV	41324	33999
PUBLIC_Undaria-pinnatifida	LG0	EVE0-1	43380500	43399000	HVH	173841120	18500
PUBLIC_Undaria-pinnatifida	LG5	EVE5-1	6291000	6347000	HVH	21972120	56000
PUBLIC_Undaria-pinnatifida	LG6	EVE6-1	9455000	9473000	HVH	12412380	18000
PUBLIC_Undaria-pinnatifida	LG22	EVE22-1	1303000	1682200	HVH	11987580	379200
Saccharina-latissima_FEMALE	S-latissima_F_contig469	S-latissima_F_EVE469-1	1	296819	V	296819	296818
Saccharina-latissima_FEMALE	S-latissima_F_contig953	S-latissima_F_EVE953-1	24000	35000	HVH	182216	11000
Saccharina-latissima_FEMALE	S-latissima_F_contig1645	S-latissima_F_EVE1645-1	1	99967	V	99967	99966
Saccharina-latissima_FEMALE	S-latissima_F_contig1794	S-latissima_F_EVE1794-1	1	87300	V	87300	87299
Saccharina-latissima_FEMALE	S-latissima_F_contig1966	S-latissima_F_EVE1966-1	1	75368	V	75368	75367
Saccharina-latissima_FEMALE	S-latissima_F_contig2036	S-latissima_F_EVE2036-1	1	70880	V	70880	70879
Saccharina-latissima_FEMALE	S-latissima_F_contig3155	S-latissima_F_EVE3155-1	1	25713	V	25713	25712
Saccorhiza-dermatodea	S-dermatodea_contig14	S-dermatodea_EVE14-1	15000	19000	HVH	60688	4000
Saccorhiza-dermatodea	S-dermatodea_contig423	S-dermatodea_EVE423-1	15000	30091	HV	30091	15091
Saccorhiza-dermatodea	S-dermatodea_contig664	S-dermatodea_EVE664-1	8500	13500	HVH	26948	5000
Saccorhiza-dermatodea	S-dermatodea_contig1002	S-dermatodea_EVE1002-1	1	23828	V	23828	23827
Saccorhiza-polyschides_FEMALE	S-polyschides_F_contig28	S-polyschides_F_EVE28-1	1	77614	V	77614	77613
Saccorhiza-polyschides_FEMALE	S-polyschides_F_contig55	S-polyschides_F_EVE55-1	1	65977	V	65977	65976
Saccorhiza-polyschides_FEMALE	S-polyschides_F_contig105	S-polyschides_F_EVE105-1	1	55663	V	55663	55662
Saccorhiza-polyschides_FEMALE	S-polyschides_F_contig143	S-polyschides_F_EVE143-1	1	51072	V	51072	51071
Saccorhiza-polyschides_FEMALE	S-polyschides_F_contig288	S-polyschides_F_EVE288-1	1	41190	V	41190	41189
Saccorhiza-polyschides_FEMALE	S-polyschides_F_contig313	S-polyschides_F_EVE313-1	1	40451	V	40451	40450
Saccorhiza-polyschides_FEMALE	S-polyschides_F_contig377	S-polyschides_F_EVE377-1	1	38399	V	38399	38398
Saccorhiza-polyschides_FEMALE	S-polyschides_F_contig433	S-polyschides_F_EVE433-1	1	37070	V	37070	37069
Saccorhiza-polyschides_FEMALE	S-polyschides_F_contig486	S-polyschides_F_EVE486-1	1	36120	V	36120	36119
Saccorhiza-polyschides_FEMALE	S-polyschides_F_contig574	S-polyschides_F_EVE574-1	1	34045	V	34045	34044
Saccorhiza-polyschides_FEMALE	S-polyschides_F_contig656	S-polyschides_F_EVE656-1	1	32743	V	32743	32742
Saccorhiza-polyschides_FEMALE	S-polyschides_F_contig892	S-polyschides_F_EVE892-1	1	29881	V	29881	29880
Saccorhiza-polyschides_FEMALE	S-polyschides_F_contig1360	S-polyschides_F_EVE1360-1	1	26092	V	26092	26091
Saccorhiza-polyschides_FEMALE	S-polyschides_F_contig1740	S-polyschides_F_EVE1740-1	1	23776	V	23776	23775
Saccorhiza-polyschides_FEMALE	S-polyschides_F_contig2752	S-polyschides_F_EVE2752-1	1	19957	V	19957	19956
Saccorhiza-polyschides_FEMALE	S-polyschides_F_contig4328	S-polyschides_F_EVE4328-1	1	16520	V	16520	16519
Saccorhiza-polyschides_FEMALE	S-polyschides_F_contig5167	S-polyschides_F_EVE5167-1	1	15233	V	15233	15232
Saccorhiza-polyschides_FEMALE	S-polyschides_F_contig5799	S-polyschides_F_EVE5799-1	1	14397	V	14397	14396
Saccorhiza-polyschides_FEMALE	S-polyschides_F_contig6175	S-polyschides_F_EVE6175-1	1	13946	V	13946	13945
Saccorhiza-polyschides_FEMALE	S-polyschides_F_contig18369	S-polyschides_F_EVE18369-1	1	7228	V	7228	7227
Saccorhiza-polyschides_MALE	S-polyschides_M_contig22	S-polyschides_M_EVE22-1	1	139146	V	139146	139145
Saccorhiza-polyschides_MALE	S-polyschides_M_contig88	S-polyschides_M_EVE88-1	1	92170	V	92170	92169
Saccorhiza-polyschides_MALE	S-polyschides_M_contig154	S-polyschides_M_EVE154-1	1	77059	V	77059	77058
Saccorhiza-polyschides_MALE	S-polyschides_M_contig270	S-polyschides_M_EVE270-1	1	65736	V	65736	65735
Saccorhiza-polyschides_MALE	S-polyschides_M_contig341	S-polyschides_M_EVE341-1	1	60971	V	60971	60970
Saccorhiza-polyschides_MALE	S-polyschides_M_contig379	S-polyschides_M_EVE379-1	1	58837	V	58837	58836
Saccorhiza-polyschides_MALE	S-polyschides_M_contig411	S-polyschides_M_EVE411-1	1	56855	V	56855	56854
Saccorhiza-polyschides_MALE	S-polyschides_M_contig1047	S-polyschides_M_EVE1047-1	1	32000	HV	40980	31999
Saccorhiza-polyschides_MALE	S-polyschides_M_contig1184	S-polyschides_M_EVE1184-1	1	39133	V	39133	39132
Saccorhiza-polyschides_MALE	S-polyschides_M_contig1397	S-polyschides_M_EVE1397-1	1	36808	V	36808	36807
Saccorhiza-polyschides_MALE	S-polyschides_M_contig1730	S-polyschides_M_EVE1730-1	1	33885	V	33885	33884
Saccorhiza-polyschides_MALE	S-polyschides_M_contig2839	S-polyschides_M_EVE2839-1	1	27177	V	27177	27176
Saccorhiza-polyschides_MALE	S-polyschides_M_contig3166	S-polyschides_M_EVE3166-1	1	25794	V	25794	25793
Saccorhiza-polyschides_MALE	S-polyschides_M_contig4027	S-polyschides_M_EVE4027-1	1	22965	V	22965	22964
Saccorhiza-polyschides_MALE	S-polyschides_M_contig6269	S-polyschides_M_EVE6269-1	1	17989	V	17989	17988
Saccorhiza-polyschides_MALE	S-polyschides_M_contig8504	S-polyschides_M_EVE8504-1	1	14879	V	14879	14878
Saccorhiza-polyschides_MALE	S-polyschides_M_contig12043	S-polyschides_M_EVE12043-1	1	11563	V	11563	11562
Saccorhiza-polyschides_MALE	S-polyschides_M_contig18790	S-polyschides_M_EVE18790-1	1	7827	V	7827	7826
Saccorhiza-polyschides_MALE	S-polyschides_M_contig21109	S-polyschides_M_EVE21109-1	1	6963	V	6963	6962
Saccorhiza-polyschides_MALE	S-polyschides_M_contig21692	S-polyschides_M_EVE21692-1	1	6765	V	6765	6764
Saccorhiza-polyschides_MALE	S-polyschides_M_contig25313	S-polyschides_M_EVE25313-1	1	5711	V	5711	5710
Schizocladia-ischiensis	S-ischiensis_contig31	S-ischiensis_EVE31-1	1515000	1558000	HVH	2301142	43000
Schizocladia-ischiensis	S-ischiensis_contig60	S-ischiensis_EVE60-1	390000	455000	HVH	1247152	65000
Schizocladia-ischiensis	S-ischiensis_contig80	S-ischiensis_EVE80-1	549000	607000	HVH	751246	58000
Scytosiphon-promiscuus_MALE	S-promiscuus_M_contig26	S-promiscuus_M_EVE26-1	2847000	2885000	HVH	2911072	38000
Scytosiphon-promiscuus_MALE	S-promiscuus_M_contig74	S-promiscuus_M_EVE74-1	63700	320500	HVH	327714	256800
Sphaerotrichia-firma_FEMALE	S-firma_F_contig1	S-firma_F_EVE1-1	1	156751	V	156751	156750
Sphaerotrichia-firma_FEMALE	S-firma_F_contig199	S-firma_F_EVE199-1	1	48222	V	48222	48221
Sphaerotrichia-firma_FEMALE	S-firma_F_contig237	S-firma_F_EVE237-1	1	46111	V	46111	46110
Sphaerotrichia-firma_FEMALE	S-firma_F_contig528	S-firma_F_EVE528-1	1	34937	V	34937	34936
Sphaerotrichia-firma_FEMALE	S-firma_F_contig756	S-firma_F_EVE756-1	1	30094	V	30094	30093
Sphaerotrichia-firma_FEMALE	S-firma_F_contig1100	S-firma_F_EVE1100-1	1	25562	V	25562	25561
Sphaerotrichia-firma_FEMALE	S-firma_F_contig4170	S-firma_F_EVE4170-1	1	11805	V	11805	11804
Sphaerotrichia-firma_MALE	S-firma_M_contig9	S-firma_M_EVE9-1	1	85000	HV	88214	84999
Sphaerotrichia-firma_MALE	S-firma_M_contig18	S-firma_M_EVE18-1	1	79699	V	79699	79698
Sphaerotrichia-firma_MALE	S-firma_M_contig695	S-firma_M_EVE695-1	1	17000	HV	30091	16999
Sphaerotrichia-firma_MALE	S-firma_M_contig772	S-firma_M_EVE772-1	1	28780	V	28780	28779
Sphaerotrichia-firma_MALE	S-firma_M_contig1309	S-firma_M_EVE1309-1	1	22760	V	22760	22759
Sphaerotrichia-firma_MALE	S-firma_M_contig1496	S-firma_M_EVE1496-1	1	21209	V	21209	21208
Sphaerotrichia-firma_MALE	S-firma_M_contig2109	S-firma_M_EVE2109-1	1	17457	V	17457	17456
Sphaerotrichia-firma_MALE	S-firma_M_contig2231	S-firma_M_EVE2231-1	1	16760	V	16760	16759
Sphaerotrichia-firma_MALE	S-firma_M_contig3062	S-firma_M_EVE3062-1	1	13656	V	13656	13655
Sphaerotrichia-firma_MALE	S-firma_M_contig14085	S-firma_M_EVE14085-1	1	2044	V	2044	2043
Undaria-pinnatifida_FEMALE	U-pinnatifida_F_contig471	U-pinnatifida_F_EVE471-1	1	33633	V	33633	33632
Undaria-pinnatifida_FEMALE	U-pinnatifida_F_contig1759	U-pinnatifida_F_EVE1759-1	1	21744	V	21744	21743
Undaria-pinnatifida_FEMALE	U-pinnatifida_F_contig2665	U-pinnatifida_F_EVE2665-1	1	18727	V	18727	18726
Undaria-pinnatifida_FEMALE	U-pinnatifida_F_contig2844	U-pinnatifida_F_EVE2844-1	1	18290	V	18290	18289
Undaria-pinnatifida_FEMALE	U-pinnatifida_F_contig3131	U-pinnatifida_F_EVE3131-1	1	17639	V	17639	17638
Undaria-pinnatifida_FEMALE	U-pinnatifida_F_contig4943	U-pinnatifida_F_EVE4943-1	1	14741	V	14741	14740
Undaria-pinnatifida_FEMALE	U-pinnatifida_F_contig6383	U-pinnatifida_F_EVE6383-1	1	13158	V	13158	13157
Undaria-pinnatifida_FEMALE	U-pinnatifida_F_contig22362	U-pinnatifida_F_EVE22362-1	1	6366	V	6366	6365
Undaria-pinnatifida_FEMALE	U-pinnatifida_F_contig24036	U-pinnatifida_F_EVE24036-1	1	6017	V	6017	6016
Undaria-pinnatifida_FEMALE	U-pinnatifida_F_contig26620	U-pinnatifida_F_EVE26620-1	1	5532	V	5532	5531
Undaria-pinnatifida_MALE	U-pinnatifida_M_contig2286	U-pinnatifida_M_EVE2286-1	1	33749	V	33749	33748
Undaria-pinnatifida_MALE	U-pinnatifida_M_contig2308	U-pinnatifida_M_EVE2308-1	1	33643	V	33643	33642
Undaria-pinnatifida_MALE	U-pinnatifida_M_contig2533	U-pinnatifida_M_EVE2533-1	1	32577	V	32577	32576
Undaria-pinnatifida_MALE	U-pinnatifida_M_contig4068	U-pinnatifida_M_EVE4068-1	1	26631	V	26631	26630
Undaria-pinnatifida_MALE	U-pinnatifida_M_contig6100	U-pinnatifida_M_EVE6100-1	1	21734	V	21734	21733
Undaria-pinnatifida_MALE	U-pinnatifida_M_contig15881	U-pinnatifida_M_EVE15881-1	1	11153	V	11153	11152

